year,st,firms,estabs,emp,denom,estabs_entry,estabs_entry_rate,estabs_exit,estabs_exit_rate,job_creation,job_creation_births,job_creation_continuers,job_creation_rate_births,job_creation_rate,job_destruction,job_destruction_deaths,job_destruction_continuers,job_destruction_rate_deaths,job_destruction_rate,net_job_creation,net_job_creation_rate,reallocation_rate,firmdeath_firms,firmdeath_estabs,firmdeath_emp
1978,1,54597,65213,1010067,972627,10457,16.375,7749,12.135,216097,76167,139930,7.831,22.218,141919,60090,81829,6.178,14.591,74178,7.627,29.183,5248,5329,28257
1979,1,55893,66797,1066814,1037995,9668,14.701,7604,11.562,220293,76618,143675,7.381,21.223,162194,60352,101842,5.814,15.626,58099,5.597,31.251,5234,5294,29467
1980,1,54838,66095,1060558,1064141,8714,13.168,8871,13.406,172732,65734,106998,6.177,16.232,179985,59422,120563,5.584,16.914,-7253,-0.682,32.464,6058,6128,32427
1981,1,54791,66410,1047044,1051448,8371,12.687,7516,11.391,164056,70115,93941,6.668,15.603,173188,51937,121251,4.94,16.471,-9132,-0.869,31.206,5176,5269,27038
1982,1,53219,65276,1033194,1037728,8185,12.497,8621,13.163,171970,73083,98887,7.043,16.572,181628,61970,119658,5.972,17.502,-9658,-0.931,33.144,6077,6147,34073
1983,1,53724,65380,1008219,1012807,8371,12.942,6970,10.776,171697,66389,105308,6.555,16.953,180203,57417,122786,5.669,17.792,-8506,-0.84,33.905,4537,4663,27346
1984,1,57267,69519,1103379,1054020,10726,16.006,5712,8.524,220367,79566,140801,7.549,20.907,121292,39249,82043,3.724,11.508,99075,9.4,23.015,4265,4320,22686
1985,1,58402,70932,1176089,1148409,10063,14.453,7449,10.699,215394,80918,134476,7.046,18.756,160469,60504,99965,5.269,13.973,54925,4.783,27.946,5377,5480,33204
1986,1,59182,72289,1190161,1166259,10218,14.4,7555,10.647,227308,90341,136967,7.746,19.49,180446,58733,121713,5.036,15.472,46862,4.018,30.944,5330,5449,30834
1987,1,60479,73979,1204831,1196881,10683,14.714,7937,10.932,221489,85554,135935,7.148,18.506,205284,71790,133494,5.998,17.152,16205,1.354,34.303,5412,5530,34257
1988,1,62286,76624,1238578,1222477,10603,14.097,7781,10.345,218042,91978,126064,7.524,17.836,185499,65161,120338,5.33,15.174,32543,2.662,30.348,5451,5547,34052
1989,1,63461,78473,1307763,1269650,10613,13.766,7861,10.196,241658,94892,146766,7.474,19.033,165904,55953,109951,4.407,13.067,75754,5.967,26.134,5647,5782,33792
1990,1,64371,79859,1359821,1335271,10084,12.801,7914,10.046,229668,79153,150515,5.928,17.2,180807,59253,121554,4.438,13.541,48861,3.659,27.082,5850,5991,37617
1991,1,64112,80427,1351744,1353605,9871,12.392,8329,10.456,212247,92206,120041,6.812,15.68,215385,75437,139948,5.573,15.912,-3138,-0.232,31.36,5870,6009,46381
1992,1,64731,81195,1373375,1363065,9465,11.78,7766,9.666,218703,77922,140781,5.717,16.045,196471,62867,133604,4.612,14.414,22232,1.631,28.828,5277,5409,34547
1993,1,66352,82781,1415069,1393469,9635,11.774,7741,9.459,222607,66321,156286,4.759,15.975,178920,65310,113610,4.687,12.84,43687,3.135,25.68,5179,5318,30535
1994,1,68332,85126,1456738,1438949,10521,12.544,8020,9.562,227096,86407,140689,6.005,15.782,192124,64434,127690,4.478,13.352,34972,2.43,26.703,5549,5688,37294
1995,1,70251,87575,1520399,1484503,10640,12.343,7901,9.165,248290,85993,162297,5.793,16.725,176132,58264,117868,3.925,11.865,72158,4.861,23.729,5581,5720,34054
1996,1,71167,89144,1525097,1517424,10623,12.066,8413,9.556,231337,82504,148833,5.437,15.245,215511,74287,141224,4.896,14.202,15826,1.043,28.405,6063,6181,39886
1997,1,71754,90163,1553963,1541084,10794,12.061,9453,10.563,268069,101064,167005,6.558,17.395,242944,89592,153352,5.814,15.764,25125,1.63,31.529,6437,6576,46127
1998,1,72280,91061,1590895,1586686,10186,11.246,9215,10.174,248754,87481,161273,5.513,15.678,238578,96233,142345,6.065,15.036,10176,0.641,30.073,6205,6376,39593
1999,1,72253,91601,1620294,1604978,9885,10.848,8925,9.795,261164,103526,157638,6.45,16.272,231106,83777,147329,5.22,14.399,30058,1.873,28.799,6031,6204,39923
2000,1,71665,91129,1654806,1637765,9293,10.196,9316,10.222,258477,80802,177675,4.934,15.782,225318,84159,141159,5.139,13.758,33159,2.025,27.515,6108,6331,42007
2001,1,70660,90778,1617445,1633666,9546,10.524,9398,10.361,234686,96026,138660,5.878,14.366,266644,88908,177736,5.442,16.322,-31958,-1.956,28.731,6092,6397,47004
2002,1,70708,91358,1577429,1598498,10202,11.213,9461,10.398,255687,98302,157385,6.15,15.995,297853,102198,195655,6.393,18.633,-42166,-2.638,31.991,5893,6089,57557
2003,1,70985,91829,1595565,1586021,9420,10.305,8594,9.401,249773,75279,174494,4.746,15.748,229896,74798,155098,4.716,14.495,19877,1.253,28.99,5589,5665,32841
2004,1,71716,92756,1633839,1613771,9487,10.298,8224,8.927,250861,82394,168467,5.106,15.545,211774,70731,141043,4.383,13.123,39087,2.422,26.246,5330,5406,34156
2005,1,72486,94135,1677501,1655548,9912,10.625,8219,8.81,265796,84227,181569,5.088,16.055,223254,64844,158410,3.917,13.485,42542,2.57,26.97,5440,5546,31005
2006,1,73344,96097,1710209,1693179,11236,11.84,8847,9.322,269483,107056,162427,6.323,15.916,235732,76568,159164,4.522,13.922,33751,1.993,27.845,6198,6317,38401
2007,1,74189,97819,1716140,1712797,10726,11.087,8573,8.862,256697,91951,164746,5.368,14.987,249859,76100,173759,4.443,14.588,6838,0.399,29.176,5471,5647,34048
2008,1,73362,97199,1707514,1710759,9037,9.286,9280,9.536,235860,77158,158702,4.51,13.787,242335,82806,159529,4.84,14.165,-6475,-0.378,27.574,6102,6293,36872
2009,1,71187,94859,1607243,1659173,7586,7.905,9806,10.218,170323,62314,108009,3.756,10.266,274710,69678,205032,4.2,16.557,-104387,-6.292,20.531,6534,6726,35954
2010,1,69404,93066,1569617,1586913,7396,7.892,8699,9.282,178049,61350,116699,3.866,11.22,212214,57025,155189,3.593,13.373,-34165,-2.153,22.44,5680,5817,29386
2011,1,68310,91895,1588552,1578159,7457,8.079,8260,8.949,209375,53862,155513,3.413,13.267,185970,54667,131303,3.464,11.784,23405,1.483,23.568,5159,5446,26274
2012,1,67979,91744,1583111,1585129,7737,8.444,7496,8.181,202904,57966,144938,3.657,12.8,207739,57853,149886,3.65,13.105,-4835,-0.305,25.601,4682,4815,28861
2013,1,67609,91387,1594412,1587325,7407,8.107,7365,8.061,193526,53164,140362,3.349,12.192,179474,59900,119574,3.774,11.307,14052,0.885,22.613,4563,4650,28415
2014,1,67538,91855,1601165,1595733,7390,8.077,6669,7.289,191394,61301,130093,3.842,11.994,181013,51361,129652,3.219,11.344,10381,0.651,22.687,4324,4445,25458
2015,1,67458,92448,1632403,1615483,7711,8.382,6813,7.406,198497,62884,135613,3.893,12.287,165119,52360,112759,3.241,10.221,33378,2.066,20.442,4382,4538,25976
2016,1,68123,93762,1673386,1652706,7713,8.296,6137,6.601,199649,66167,133482,4.004,12.08,156916,44704,112212,2.705,9.494,42733,2.586,18.989,4155,4274,23426
2017,1,68250,93828,1695699,1682109,7482,7.989,7140,7.624,219671,54454,165217,3.237,13.059,191740,57003,134737,3.389,11.399,27931,1.66,22.798,4541,4674,28225
2018,1,68159,93502,1727979,1712580,6695,7.159,6725,7.191,203011,54749,148262,3.197,11.854,173305,46993,126312,2.744,10.12,29706,1.735,20.239,4744,4957,27152
1978,2,7107,8396,106610,107425,1924,23.813,1291,15.979,35127,14756,20371,13.736,32.699,36645,18526,18119,17.246,34.112,-1518,-1.413,65.398,828,834,8775
1979,2,7264,8555,107600,106684,1658,19.726,1358,16.157,27519,10369,17150,9.719,25.795,25829,9389,16440,8.801,24.211,1690,1.584,48.422,853,865,4695
1980,2,7123,8447,103889,105361,1431,16.964,1408,16.691,23277,9344,13933,8.869,22.093,26258,10490,15768,9.956,24.922,-2981,-2.829,44.185,898,911,4314
1981,2,7477,8854,115373,109264,1597,18.594,1067,12.423,31523,11247,20276,10.293,28.85,19197,7287,11910,6.669,17.569,12326,11.281,35.139,637,642,3990
1982,2,8073,9538,130891,123553,1992,21.786,1203,13.157,40244,15524,24720,12.565,32.572,25676,8147,17529,6.594,20.781,14568,11.791,41.563,783,793,4447
1983,2,9181,10814,135765,131831,2520,24.96,1084,10.737,37503,16529,20974,12.538,28.448,29845,9270,20575,7.032,22.639,7658,5.809,45.278,723,741,4986
1984,2,10256,11948,144897,139620,2614,23.146,1305,11.555,37492,16063,21429,11.505,26.853,26946,8969,17977,6.424,19.3,10546,7.553,38.599,923,940,5870
1985,2,10566,12320,150745,145820,2434,20.261,1821,15.158,40077,15416,24661,10.572,27.484,30021,11906,18115,8.165,20.588,10056,6.896,41.176,1338,1352,7787
1986,2,10460,12285,145402,146531,2260,18.6,1991,16.386,34666,15146,19520,10.336,23.658,36759,11244,25515,7.673,25.086,-2093,-1.428,47.316,1456,1485,8005
1987,2,9904,11678,138724,140710,1903,16.068,2234,18.863,32816,15764,17052,11.203,23.322,37054,14872,22182,10.569,26.334,-4238,-3.012,46.643,1563,1622,9593
1988,2,10018,11880,136951,137484,1974,16.806,1706,14.524,30590,13158,17432,9.571,22.25,31622,12459,19163,9.062,23.001,-1032,-0.751,44.5,1096,1109,5804
1989,2,10323,12292,144960,140590,1930,16.082,1348,11.232,31760,11911,19849,8.472,22.591,23143,8159,14984,5.803,16.461,8617,6.129,32.923,930,953,4913
1990,2,10621,12700,159106,151759,1918,15.448,1350,10.873,35968,11297,24671,7.444,23.701,21209,7758,13451,5.112,13.975,14759,9.725,27.951,946,972,5597
1991,2,10820,13101,162162,160745,1935,15.084,1390,10.835,32507,12351,20156,7.684,20.223,29688,8562,21126,5.326,18.469,2819,1.754,36.938,898,920,5339
1992,2,11012,13400,166667,166512,1823,13.855,1339,10.176,35709,11061,24648,6.643,21.445,34673,8568,26105,5.146,20.823,1036,0.622,41.646,827,845,4892
1993,2,11312,13607,165735,166008,1742,12.932,1468,10.898,29581,8833,20748,5.321,17.819,30301,9997,20304,6.022,18.253,-720,-0.434,35.638,866,903,4948
1994,2,11684,13999,173801,170636,1852,13.424,1446,10.481,33973,12441,21532,7.291,19.91,27826,8955,18871,5.248,16.307,6147,3.602,32.615,913,938,4644
1995,2,12066,14415,176778,174958,1890,13.33,1418,10.001,30369,10268,20101,5.869,17.358,26718,8079,18639,4.618,15.271,3651,2.087,30.542,943,970,4796
1996,2,12239,14597,177475,175718,1822,12.642,1452,10.075,29435,8475,20960,4.823,16.751,26085,8441,17644,4.804,14.845,3350,1.906,29.69,966,986,5200
1997,2,12441,14852,183994,180611,1932,13.16,1590,10.83,36485,10478,26007,5.801,20.201,29887,9270,20617,5.133,16.548,6598,3.653,33.096,1012,1024,4565
1998,2,12723,15177,196305,191940,1897,12.624,1598,10.634,36752,12673,24079,6.603,19.148,28163,8963,19200,4.67,14.673,8589,4.475,29.346,990,1026,4591
1999,2,12781,15300,196164,195532,1745,11.481,1544,10.158,29213,8803,20410,4.502,14.94,27905,7726,20179,3.951,14.271,1308,0.669,28.543,1017,1037,4300
2000,2,12785,15232,203353,200148,1770,11.613,1789,11.738,38505,13510,24995,6.75,19.238,32213,14367,17846,7.178,16.095,6292,3.144,32.189,1074,1106,5987
2001,2,12730,15311,210283,206235,1814,11.926,1614,10.611,36527,11904,24623,5.772,17.711,28417,9621,18796,4.665,13.779,8110,3.932,27.558,987,1014,5016
2002,2,12843,15617,212802,211903,2134,13.819,1786,11.565,39629,15427,24202,7.28,18.701,37863,12289,25574,5.799,17.868,1766,0.833,35.736,1019,1032,6725
2003,2,13068,15931,217690,214498,1966,12.493,1578,10.027,40276,14183,26093,6.612,18.777,33570,9980,23590,4.653,15.651,6706,3.126,31.301,918,941,4746
2004,2,13361,16214,223329,220392,1906,11.877,1574,9.808,35102,9634,25468,4.371,15.927,29303,10720,18583,4.864,13.296,5799,2.631,26.592,961,994,4797
2005,2,13551,16532,226482,222901,1940,11.875,1549,9.482,35661,10936,24725,4.906,15.999,28412,7330,21082,3.288,12.746,7249,3.252,25.493,1006,1031,4831
2006,2,13794,16997,241831,235770,2329,13.922,1793,10.718,41787,12597,29190,5.343,17.724,29918,9449,20469,4.008,12.69,11869,5.034,25.379,1247,1266,5881
2007,2,13833,17174,244775,243150,2022,11.866,1755,10.299,42755,14636,28119,6.019,17.584,39347,8843,30504,3.637,16.182,3408,1.402,32.364,1085,1100,4570
2008,2,13678,17021,247067,245718,1814,10.638,1875,10.996,35356,9989,25367,4.065,14.389,32758,8770,23988,3.569,13.332,2598,1.057,26.663,1158,1170,4899
2009,2,13561,16998,251208,249232,1788,10.513,1808,10.63,39233,12130,27103,4.867,15.742,35422,10859,24563,4.357,14.212,3811,1.529,28.425,1039,1075,4841
2010,2,13603,17132,253628,252452,1740,10.216,1539,9.036,33361,8717,24644,3.453,13.215,31000,7436,23564,2.946,12.28,2361,0.935,24.559,898,916,3512
2011,2,13612,17313,254222,253776,1763,10.257,1512,8.797,31511,9705,21806,3.824,12.417,30407,7388,23019,2.911,11.982,1104,0.435,23.964,910,933,3174
2012,2,13720,17416,257324,255997,1729,9.983,1536,8.869,37291,10763,26528,4.204,14.567,34514,7556,26958,2.952,13.482,2777,1.085,26.964,822,834,3225
2013,2,13795,17525,264763,260965,1733,9.94,1551,8.896,34601,9885,24716,3.788,13.259,27132,7207,19925,2.762,10.397,7469,2.862,20.794,895,913,3244
2014,2,13820,17706,264370,263781,1748,9.942,1500,8.531,37042,12959,24083,4.913,14.043,35765,9952,25813,3.773,13.559,1277,0.484,27.117,925,932,3855
2015,2,13921,17899,266269,265150,1765,9.936,1496,8.421,35858,10535,25323,3.973,13.524,33867,9120,24747,3.44,12.773,1991,0.751,25.546,923,935,4101
2016,2,14034,18114,264338,265204,1832,10.191,1559,8.672,34188,11847,22341,4.467,12.891,35956,10495,25461,3.957,13.558,-1768,-0.667,25.782,999,1021,6451
2017,2,13979,18045,259701,261491,1734,9.613,1720,9.535,34029,8500,25529,3.251,13.013,37499,12479,25020,4.772,14.34,-3470,-1.327,26.027,1094,1111,5240
2018,2,14037,18041,260427,260765,1594,8.85,1536,8.528,30688,6824,23864,2.617,11.768,31279,8206,23073,3.147,11.995,-591,-0.227,23.537,1060,1083,4032
1978,4,40042,48180,697602,652593,9597,20.575,6524,13.987,197049,79242,117807,12.143,30.195,106464,48116,58348,7.373,16.314,90585,13.881,32.628,4429,4518,25194
1979,4,42294,50940,776575,731918,9129,18.512,5878,11.919,195612,71628,123984,9.786,26.726,106643,41463,65180,5.665,14.57,88969,12.156,29.141,3888,3969,23231
1980,4,43894,53213,815428,802197,9121,17.615,6254,12.078,167147,66972,100175,8.349,20.836,140694,48276,92418,6.018,17.539,26453,3.298,35.077,4424,4497,26673
1981,4,45805,55776,835493,823862,9312,17.185,6134,11.32,159079,66337,92742,8.052,19.309,135796,38755,97041,4.704,16.483,23283,2.826,32.966,4076,4155,21916
1982,4,46899,57603,844128,838339,9751,17.294,7312,12.968,165341,71674,93667,8.55,19.722,154172,45835,108337,5.467,18.39,11169,1.332,36.78,5189,5217,28101
1983,4,49221,60427,854676,846763,10150,17.347,6317,10.796,178434,70921,107513,8.376,21.072,162580,48955,113625,5.781,19.2,15854,1.872,38.4,4231,4304,25909
1984,4,53001,64413,965516,906336,11384,18.378,6443,10.402,240307,92625,147682,10.22,26.514,122158,44018,78140,4.857,13.478,118149,13.036,26.956,4424,4532,24992
1985,4,56026,67696,1068340,1011777,12067,18.423,7673,11.715,273832,104504,169328,10.329,27.064,160717,62011,98706,6.129,15.885,113115,11.18,31.769,5425,5538,38689
1986,4,57692,70259,1123811,1089120,12234,17.931,8169,11.973,264535,112903,151632,10.366,24.289,195352,61158,134194,5.615,17.937,69183,6.352,35.873,5821,5878,38131
1987,4,59691,73033,1157595,1139042,12927,18.18,9072,12.759,260317,122004,138313,10.711,22.854,222833,88578,134255,7.777,19.563,37484,3.291,39.126,6262,6340,45772
1988,4,61972,76487,1195297,1170456,12863,17.244,9081,12.174,261001,114642,146359,9.795,22.299,212460,75478,136982,6.449,18.152,48541,4.147,36.304,6473,6583,45393
1989,4,62661,77657,1232617,1206541,12293,16.126,9442,12.386,260236,108317,151919,8.977,21.569,208014,77881,130133,6.455,17.241,52222,4.328,34.481,6739,6914,47061
1990,4,63516,78597,1252633,1237055,11759,15.187,9419,12.165,243762,98117,145645,7.932,19.705,213505,71202,142303,5.756,17.259,30257,2.446,34.518,6729,6934,44754
1991,4,64079,80042,1252142,1247435,11940,15.176,9210,11.706,241588,115728,125860,9.277,19.367,232416,83259,149157,6.674,18.632,9172,0.735,37.263,6478,6648,50628
1992,4,64975,80901,1267165,1253559,11253,14.11,8959,11.233,243160,95519,147641,7.62,19.398,216246,70430,145816,5.618,17.251,26914,2.147,34.501,5806,5959,38587
1993,4,67005,82546,1312801,1289673,11380,13.948,9461,11.596,248847,87225,161622,6.763,19.295,203711,79734,123977,6.182,15.796,45136,3.5,31.591,6012,6183,40642
1994,4,69780,86147,1415023,1365515,12813,15.2,9112,10.809,301186,116203,184983,8.51,22.057,201195,78632,122563,5.758,14.734,99991,7.323,29.468,6269,6439,40891
1995,4,72463,89419,1499240,1455041,13063,14.908,9474,10.812,294427,114225,180202,7.85,20.235,205226,80285,124941,5.518,14.104,89201,6.13,28.209,6457,6653,48705
1996,4,74315,92059,1560563,1523091,13163,14.562,9826,10.871,289902,106799,183103,7.012,19.034,214210,79942,134268,5.249,14.064,75692,4.97,28.128,6772,6962,48554
1997,4,76515,95113,1659399,1615732,14532,15.549,11221,12.007,361008,144383,216625,8.936,22.343,275185,112970,162215,6.992,17.032,85823,5.312,34.063,7259,7431,50811
1998,4,77938,97237,1757321,1712490,13076,13.598,10927,11.363,348587,137164,211423,8.01,20.356,259507,94403,165104,5.513,15.154,89080,5.202,30.308,7173,7360,50514
1999,4,79419,99623,1815667,1782802,13862,14.108,11130,11.327,354747,136915,217832,7.68,19.898,288821,116429,172392,6.531,16.2,65926,3.698,32.401,7082,7351,55373
2000,4,80271,101419,1898960,1860337,13673,13.623,11568,11.526,378584,138323,240261,7.435,20.35,300916,115456,185460,6.206,16.175,77668,4.175,32.351,7413,7666,49725
2001,4,81513,103254,1940485,1922592,14054,13.752,11935,11.679,356770,137006,219764,7.126,18.557,321233,126583,194650,6.584,16.708,35537,1.848,33.417,7185,7415,50941
2002,4,82105,104994,1930304,1937637,14800,14.229,12843,12.347,385741,157882,227859,8.148,19.908,400749,138031,262718,7.124,20.682,-15008,-0.775,39.816,7777,8046,62921
2003,4,83660,106907,1974303,1950453,14327,13.539,12156,11.487,386644,138655,247989,7.109,19.823,341382,129875,211507,6.659,17.503,45262,2.321,35.005,7561,7688,51224
2004,4,86028,109939,2033762,2002244,14648,13.517,11510,10.621,363807,128196,235611,6.403,18.17,300144,119547,180597,5.971,14.99,63663,3.18,29.981,7236,7453,48009
2005,4,89336,114648,2153839,2093589,16478,14.683,11627,10.361,411348,161598,249750,7.719,19.648,291711,99624,192087,4.759,13.934,119637,5.714,27.867,7455,7697,49142
2006,4,94664,122110,2335532,2246637,20196,17.076,12520,10.586,464553,184283,280270,8.203,20.678,285849,102773,183076,4.575,12.723,178704,7.954,25.447,8698,8866,59940
2007,4,97182,126144,2384709,2359934,18118,14.614,13782,11.117,445931,152730,293201,6.472,18.896,397402,126642,270760,5.366,16.84,48529,2.056,33.679,8814,8987,56817
2008,4,96276,125726,2309833,2346919,15810,12.566,15991,12.71,350677,130775,219902,5.572,14.942,424348,129084,295264,5.5,18.081,-73671,-3.139,29.884,10680,10877,69273
2009,4,91332,120537,2111920,2213633,13023,10.568,18401,14.933,275979,116807,159172,5.277,12.467,479226,164047,315179,7.411,21.649,-203247,-9.182,24.934,11961,12186,97131
2010,4,88457,117683,2053004,2082807,13050,10.969,15622,13.131,286946,113395,173551,5.444,13.777,346275,102516,243759,4.922,16.625,-59329,-2.849,27.554,9735,10016,50969
2011,4,87577,117014,2107291,2080200,13497,11.514,13923,11.877,321015,106013,215002,5.096,15.432,267859,95271,172588,4.58,12.877,53156,2.555,25.753,8795,9051,47988
2012,4,87774,117127,2125167,2116068,12885,11.021,12467,10.663,316876,101224,215652,4.784,14.975,300332,107347,192985,5.073,14.193,16544,0.782,28.386,7512,7736,41117
2013,4,88518,118071,2173903,2147947,12964,11.04,11678,9.945,306630,101208,205422,4.712,14.275,255465,82153,173312,3.825,11.893,51165,2.382,23.787,7152,7249,42593
2014,4,89448,120104,2227557,2200907,13260,11.145,11012,9.255,338143,113549,224594,5.159,15.364,284467,82568,201899,3.752,12.925,53676,2.439,25.85,7101,7230,42258
2015,4,90727,121791,2299424,2264930,13234,10.953,11296,9.349,329909,111694,218215,4.931,14.566,260575,83347,177228,3.68,11.505,69334,3.061,23.01,7054,7245,40318
2016,4,92513,124748,2376075,2337139,13722,11.14,10577,8.587,358115,119133,238982,5.097,15.323,280708,101929,178779,4.361,12.011,77407,3.312,24.022,6985,7191,55674
2017,4,94019,126629,2437737,2404226,13686,10.898,11592,9.231,356067,114963,241104,4.782,14.81,289177,98715,190462,4.106,12.028,66890,2.782,24.056,7428,7585,46186
2018,4,95482,128008,2542914,2490499,13095,10.295,11478,9.024,364069,116231,247838,4.667,14.618,258652,75268,183384,3.022,10.386,105417,4.233,20.771,8242,8495,46330
1978,5,36821,42075,564036,539707,7154,17.401,5227,12.714,122816,49204,73612,9.117,22.756,73746,31801,41945,5.892,13.664,49070,9.092,27.328,3858,3884,17124
1979,5,37250,42551,589212,576411,6211,14.777,5171,12.303,108945,40791,68154,7.077,18.901,82982,30517,52465,5.294,14.396,25963,4.504,28.793,3767,3804,17470
1980,5,37057,42567,591646,591536,5583,13.165,5266,12.417,96434,35458,60976,5.994,16.302,96193,30582,65611,5.17,16.262,241,0.041,32.523,3924,3985,17371
1981,5,36818,42585,591308,590284,5271,12.433,4894,11.543,91171,38031,53140,6.443,15.445,89602,25016,64586,4.238,15.179,1569,0.266,30.359,3376,3416,14736
1982,5,36204,42180,576841,582353,5560,13.193,5486,13.018,90350,37764,52586,6.485,15.515,101396,29415,71981,5.051,17.411,-11046,-1.897,31.029,3955,3986,17798
1983,5,37183,43235,574276,573190,5808,13.702,4114,9.706,92060,31912,60148,5.567,16.061,89805,27521,62284,4.801,15.668,2255,0.393,31.335,2895,2941,13177
1984,5,39236,45419,622247,596798,7062,16.039,4285,9.732,120296,42634,77662,7.144,20.157,69867,25864,44003,4.334,11.707,50429,8.45,23.414,3102,3175,14236
1985,5,39591,45875,650936,633660,6355,14.045,5101,11.273,126765,52844,73921,8.339,20.005,92375,37596,54779,5.933,14.578,34390,5.427,29.156,3836,3901,20901
1986,5,39482,45795,660566,651097,6034,13.297,5203,11.466,117877,45237,72640,6.948,18.104,98480,35292,63188,5.42,15.125,19397,2.979,30.251,3781,3848,19422
1987,5,39549,46160,682402,671678,6398,14.022,5336,11.694,122291,45431,76860,6.764,18.207,100589,35874,64715,5.341,14.976,21702,3.231,29.952,3816,3871,21076
1988,5,40139,47228,704491,694719,6324,13.566,5102,10.945,124432,44266,80166,6.372,17.911,104553,38251,66302,5.506,15.05,19879,2.861,30.099,3604,3643,21373
1989,5,40531,47923,725610,712457,6049,12.791,4782,10.112,124434,48872,75562,6.86,17.465,98554,37475,61079,5.26,13.833,25881,3.633,27.666,3554,3629,22386
1990,5,41362,48967,751678,738029,6163,12.786,4631,9.608,122915,44921,77994,6.087,16.654,95272,29373,65899,3.98,12.909,27643,3.746,25.818,3483,3541,19154
1991,5,41236,49380,757284,753246,5998,12.275,4964,10.159,118617,46347,72270,6.153,15.747,111066,34874,76192,4.63,14.745,7551,1.002,29.49,3612,3660,21679
1992,5,41708,50073,783215,774869,6025,12.189,4737,9.583,130492,44352,86140,5.724,16.841,114019,34503,79516,4.453,14.715,16473,2.126,29.429,3271,3331,20175
1993,5,43077,51382,810857,796306,6340,12.521,4849,9.576,131176,42840,88336,5.38,16.473,102628,35514,67114,4.46,12.888,28548,3.585,25.776,3321,3379,18645
1994,5,44218,52985,838017,825058,6710,12.874,4983,9.56,137063,54002,83061,6.545,16.613,110458,44062,66396,5.34,13.388,26605,3.225,26.776,3567,3655,25357
1995,5,45420,54451,880938,858672,6765,12.616,5105,9.521,147805,51194,96611,5.962,17.213,103049,41593,61456,4.844,12.001,44756,5.212,24.002,3649,3698,22992
1996,5,45793,55112,889503,882170,6477,11.871,5379,9.858,131173,45942,85231,5.208,14.869,116312,36170,80142,4.1,13.185,14861,1.685,26.37,3926,4027,22548
1997,5,46053,55612,899253,895203,6733,12.183,6037,10.924,141191,53097,88094,5.931,15.772,132973,50545,82428,5.646,14.854,8218,0.918,29.708,4210,4322,26136
1998,5,46036,55979,938177,922751,6376,11.432,5963,10.692,153523,61383,92140,6.652,16.638,122515,44589,77926,4.832,13.277,31008,3.36,26.554,4091,4190,24594
1999,5,46052,56297,949518,943436,6351,11.334,5822,10.39,142572,49784,92788,5.277,15.112,130894,48208,82686,5.11,13.874,11678,1.238,27.748,3997,4124,24834
2000,5,46170,56635,988028,968477,6342,11.259,5732,10.176,154569,50458,104111,5.21,15.96,114862,41748,73114,4.311,11.86,39707,4.1,23.72,3803,3890,21067
2001,5,45611,56506,987392,986636,6183,10.959,6009,10.651,143521,56517,87004,5.728,14.547,141628,46581,95047,4.721,14.355,1893,0.192,28.709,4114,4217,24086
2002,5,46004,57392,969132,980693,6864,12.064,5877,10.329,150543,53568,96975,5.462,15.351,174497,63744,110753,6.5,17.793,-23954,-2.443,30.701,3807,3932,24705
2003,5,46517,58258,979735,974066,6425,11.137,5295,9.178,140607,45830,94777,4.705,14.435,129318,40067,89251,4.113,13.276,11289,1.159,26.552,3545,3609,17237
2004,5,47068,58957,993507,986354,6174,10.554,5262,8.995,143911,47047,96864,4.77,14.59,130280,44766,85514,4.539,13.208,13631,1.382,26.416,3606,3665,19580
2005,5,47527,59915,1012268,1004015,6495,10.944,5364,9.038,138491,48631,89860,4.844,13.794,122376,36197,86179,3.605,12.189,16115,1.605,24.377,3824,3881,21881
2006,5,47887,61105,1042434,1026867,7483,12.399,5978,9.905,149085,55309,93776,5.386,14.518,117835,36907,80928,3.594,11.475,31250,3.043,22.95,4387,4471,23301
2007,5,48029,61715,1026303,1033552,6588,10.757,5642,9.213,143212,49684,93528,4.807,13.856,157348,45252,112096,4.378,15.224,-14136,-1.368,27.713,3771,3815,21751
2008,5,47447,61231,1011382,1017922,5700,9.291,5932,9.67,126793,41422,85371,4.069,12.456,139984,40297,99687,3.959,13.752,-13191,-1.296,24.912,4007,4087,21950
2009,5,46617,60486,968495,990343,5383,8.846,6119,10.055,110926,43892,67034,4.432,11.201,155009,44001,111008,4.443,15.652,-44083,-4.451,22.402,4090,4185,25139
2010,5,46127,60158,963807,966526,5162,8.573,5277,8.764,115235,39359,75876,4.072,11.923,120217,33937,86280,3.511,12.438,-4982,-0.515,23.845,3472,3580,20230
2011,5,45703,59851,976330,969367,5216,8.712,5260,8.785,122759,39398,83361,4.064,12.664,109340,30284,79056,3.124,11.28,13419,1.384,22.559,3419,3579,16934
2012,5,45646,59746,971834,973269,5001,8.381,4846,8.122,116235,29737,86498,3.055,11.943,119139,35352,83787,3.632,12.241,-2904,-0.298,23.885,3088,3165,17744
2013,5,45507,59766,975274,973906,5164,8.661,4886,8.194,115974,35851,80123,3.681,11.908,112898,39943,72955,4.101,11.592,3076,0.316,23.185,3164,3246,19218
2014,5,45398,59808,986083,980549,4830,8.093,4573,7.663,114333,35568,78765,3.627,11.66,103323,36381,66942,3.71,10.537,11010,1.123,21.075,3107,3164,15675
2015,5,45337,60061,998946,992222,5065,8.467,4578,7.653,119779,38191,81588,3.849,12.072,106859,34246,72613,3.451,10.77,12920,1.302,21.539,2973,3038,17254
2016,5,45669,60907,1020449,1009435,5447,9.018,4435,7.343,123369,41527,81842,4.114,12.222,101338,27543,73795,2.729,10.039,22031,2.183,20.078,3065,3110,17133
2017,5,45771,61242,1025945,1018685,5220,8.56,4699,7.706,133242,39656,93586,3.893,13.08,118504,35957,82547,3.53,11.633,14738,1.447,23.266,3086,3181,18229
2018,5,45821,61356,1039975,1032493,4857,7.938,4518,7.384,119444,33312,86132,3.226,11.569,103988,29633,74355,2.87,10.072,15456,1.497,20.143,3306,3425,19374
1978,6,388167,465390,7254570,6908830,83583,18.506,56123,12.426,1774939,673848,1101091,9.753,25.691,1084342,475348,608994,6.88,15.695,690597,9.996,31.39,37511,38060,220386
1979,6,409260,490241,7912639,7581633,82180,17.278,52963,11.135,1780287,638411,1141876,8.42,23.482,1121676,440516,681160,5.81,14.795,658611,8.687,29.589,35007,35510,205178
1980,6,417693,503069,8116960,8005135,78324,15.855,60190,12.184,1611691,647919,963772,8.094,20.133,1385730,503989,881741,6.296,17.311,225961,2.823,34.621,41632,42318,249960
1981,6,429111,517803,8253675,8178273,76452,15.058,56264,11.082,1531608,590584,941024,7.221,18.728,1378565,432454,946111,5.288,16.856,153043,1.871,33.713,36077,36849,203656
1982,6,428293,520646,8302032,8265045,76261,14.781,66837,12.955,1583085,650563,932522,7.871,19.154,1507407,489669,1017738,5.925,18.238,75678,0.916,36.477,45757,46490,252997
1983,6,438923,531364,8223990,8185239,75505,14.486,55207,10.592,1580897,574920,1005977,7.024,19.314,1500090,460002,1040088,5.62,18.327,80807,0.987,36.654,36050,36838,229806
1984,6,461614,555826,8929906,8532362,85537,15.854,52966,9.817,1971471,705365,1266106,8.267,23.106,1177666,395097,782569,4.631,13.802,793805,9.303,27.605,36405,37140,219166
1985,6,475896,569973,9291204,9058142,87509,15.679,63839,11.438,1961384,728648,1232736,8.044,21.653,1495909,559725,936184,6.179,16.515,465475,5.139,33.029,44699,45603,316213
1986,6,485992,584988,9580574,9358108,89640,15.676,63337,11.076,2019749,802749,1217000,8.578,21.583,1575825,511251,1064574,5.463,16.839,443924,4.744,33.678,44001,44809,284392
1987,6,499970,603068,9974821,9806561,95279,16.161,68248,11.576,2186816,872760,1314056,8.9,22.3,1850803,627340,1223463,6.397,18.873,336013,3.426,37.746,46507,47486,321078
1988,6,517463,627986,10407426,10199051,95114,15.475,68434,11.134,2204066,827887,1376179,8.117,21.611,1787193,620350,1166843,6.082,17.523,416873,4.087,35.046,47522,48607,337018
1989,6,528706,644424,10823029,10578460,94982,15.039,69301,10.973,2170984,799169,1371815,7.555,20.523,1686117,580779,1105338,5.49,15.939,484867,4.584,31.878,48868,50155,334073
1990,6,542302,661805,11288407,11042136,94666,14.582,69485,10.703,2194963,807137,1387826,7.31,19.878,1703828,584150,1119678,5.29,15.43,491135,4.448,30.86,50313,51586,351976
1991,6,539838,667149,10828757,11019024,92231,13.983,77080,11.686,1817950,753103,1064847,6.835,16.498,2199900,704405,1495495,6.393,19.965,-381950,-3.466,32.997,55181,56498,450920
1992,6,532548,660089,10478442,10614901,82513,12.533,79099,12.014,1812256,660092,1152164,6.219,17.073,2080033,735241,1344792,6.926,19.595,-267777,-2.523,34.146,53190,54575,404643
1993,6,526945,649682,10451223,10499266,76433,11.692,84555,12.934,1812167,601224,1210943,5.726,17.26,1916127,713507,1202620,6.796,18.25,-103960,-0.99,34.52,54478,56024,348016
1994,6,527616,650515,10449917,10436806,81244,12.503,79806,12.282,1825573,708034,1117539,6.784,17.492,1801156,649369,1151787,6.222,17.258,24417,0.234,34.515,52673,54490,364733
1995,6,532357,656981,10720536,10578185,82731,12.674,74332,11.387,1858514,663176,1195338,6.269,17.569,1575083,560296,1014787,5.297,14.89,283431,2.679,29.78,50332,52023,316885
1996,6,537533,663094,10851062,10753607,83715,12.729,72863,11.079,1897527,668065,1229462,6.212,17.645,1700948,616029,1084919,5.729,15.817,196579,1.828,31.635,49465,51059,329707
1997,6,543194,667890,11262734,11070002,87187,13.118,80651,12.135,2239021,805420,1433601,7.276,20.226,1849292,724531,1124761,6.545,16.705,389729,3.521,33.411,50400,52290,355608
1998,6,554143,681297,11887181,11643003,84525,12.523,71854,10.646,2216615,735907,1480708,6.321,19.038,1726477,634008,1092469,5.445,14.828,490138,4.21,29.657,45643,46858,310285
1999,6,561686,691079,12147334,12024842,84495,12.331,72809,10.625,2156124,761124,1395000,6.33,17.931,1914959,707422,1207537,5.883,15.925,241165,2.006,31.85,45798,47378,343390
2000,6,569684,701434,12664975,12417141,84128,12.098,72089,10.366,2363097,790292,1572805,6.365,19.031,1864349,708650,1155699,5.707,15.014,498748,4.017,30.029,45342,47122,314415
2001,6,575392,711343,12948371,12794874,86510,12.261,75004,10.63,2270230,778103,1492127,6.081,17.743,1965764,685672,1280092,5.359,15.364,304466,2.38,30.727,48040,49527,344037
2002,6,578723,720990,12621846,12832448,94957,13.261,85128,11.888,2285718,922727,1362991,7.191,17.812,2710267,923782,1786485,7.199,21.12,-424549,-3.308,35.624,53138,55043,483486
2003,6,587503,729620,12767062,12688864,90021,12.426,79684,10.999,2235686,757210,1478476,5.968,17.619,2075780,693803,1381977,5.468,16.359,159906,1.26,32.718,50627,52306,352660
2004,6,595371,738329,12963967,12862909,89180,12.159,79408,10.827,2140066,719153,1420913,5.591,16.637,1949613,708665,1240948,5.509,15.157,190453,1.481,30.314,51231,52771,358454
2005,6,607480,754599,13158123,13073817,96960,12.999,79540,10.664,2098026,769289,1328737,5.884,16.048,1924583,621016,1303567,4.75,14.721,173443,1.327,29.442,53608,54919,346704
2006,6,625061,779399,13714584,13460043,111144,14.505,84800,11.067,2376656,905679,1470977,6.729,17.657,1867633,643442,1224191,4.78,13.875,509023,3.782,27.751,60889,61953,373345
2007,6,633052,791042,13713451,13712694,100052,12.759,86295,11.005,2179328,751419,1427909,5.48,15.893,2178157,708648,1469509,5.168,15.884,1171,0.009,31.768,56173,57251,351001
2008,6,626773,785847,13539103,13592517,87508,11.111,90989,11.553,2003122,655765,1347357,4.824,14.737,2118755,698205,1420550,5.137,15.588,-115633,-0.851,29.474,60497,61655,372534
2009,6,610271,768227,12736676,13168352,78187,10.055,96943,12.467,1551518,579987,971531,4.404,11.782,2415798,696467,1719331,5.289,18.345,-864280,-6.563,23.564,63112,64550,391568
2010,6,598927,756795,12338121,12535396,77204,10.134,87263,11.454,1533435,537472,995963,4.288,12.233,1925674,593411,1332263,4.734,15.362,-392239,-3.129,24.466,54919,56267,302415
2011,6,599746,759404,12547431,12440046,82304,10.867,78293,10.337,1734090,546393,1187697,4.392,13.94,1522765,521526,1001239,4.192,12.241,211325,1.699,24.482,49847,51191,264762
2012,6,608205,767374,12811165,12672493,84615,11.098,74686,9.796,1851519,542977,1308542,4.285,14.611,1574905,524050,1050855,4.135,12.428,276614,2.183,24.855,45496,46641,259763
2013,6,614222,773543,13222274,13009569,84010,10.919,75714,9.841,1962815,633932,1328883,4.873,15.087,1533666,543133,990533,4.175,11.789,429149,3.299,23.578,47037,47898,270811
2014,6,625384,788780,13602500,13400335,87774,11.245,71304,9.135,1985755,651334,1334421,4.861,14.819,1585311,530048,1055263,3.955,11.83,400444,2.988,23.661,46954,47858,265328
2015,6,635579,803128,14071448,13834059,88785,11.165,72913,9.169,2013067,674620,1338447,4.877,14.552,1536785,514000,1022785,3.715,11.109,476282,3.443,22.217,48698,49599,293117
2016,6,647486,819785,14360390,14198321,91200,11.247,73388,9.05,2030776,644426,1386350,4.539,14.303,1698892,631283,1067609,4.446,11.965,331884,2.337,23.931,50908,51920,311536
2017,6,655520,828908,14660379,14489378,89150,10.824,78630,9.547,2146122,660952,1485170,4.562,14.812,1803155,614499,1188656,4.241,12.445,342967,2.367,24.889,53714,54931,335526
2018,6,664454,836870,15041020,14858030,86406,10.383,76990,9.252,2008857,643240,1365617,4.329,13.52,1639726,528312,1111414,3.556,11.036,369131,2.484,22.072,57934,59554,339032
1978,8,55138,64192,912281,856993,12341,19.801,8605,13.807,239376,88424,150952,10.318,27.932,128578,57695,70883,6.732,15.003,110798,12.929,30.007,5921,6004,29345
1979,8,58322,67650,1002887,958466,11899,18.138,7807,11.9,231753,85417,146336,8.912,24.18,142458,58777,83681,6.132,14.863,89295,9.316,29.726,5226,5296,29163
1980,8,59565,69408,1041788,1023356,11399,16.739,8783,12.897,212316,84412,127904,8.249,20.747,175582,68800,106782,6.723,17.157,36734,3.59,34.315,6169,6277,42594
1981,8,61181,71736,1079369,1059402,11465,16.352,8219,11.723,224248,90470,133778,8.54,21.167,184324,60622,123702,5.722,17.399,39924,3.769,34.798,5632,5715,33135
1982,8,62496,73812,1113030,1094917,12418,17.164,9490,13.117,235671,95464,140207,8.719,21.524,199985,70045,129940,6.397,18.265,35686,3.259,36.53,6701,6777,37850
1983,8,64842,76472,1117399,1112410,12301,16.512,8352,11.211,229966,100602,129364,9.044,20.673,219957,60203,159754,5.412,19.773,10009,0.9,39.546,5788,5870,35044
1984,8,68424,80480,1181758,1141837,13633,17.514,8354,10.732,253234,102259,150975,8.956,22.178,173477,57195,116282,5.009,15.193,79757,6.985,30.386,6119,6201,32852
1985,8,69586,81777,1219306,1194081,13339,16.611,10389,12.937,253933,95239,158694,7.976,21.266,204405,78657,125748,6.587,17.118,49528,4.148,34.236,7637,7799,51362
1986,8,69393,82167,1218751,1208994,12874,15.891,10565,13.041,237092,101378,135714,8.385,19.611,217879,78146,139733,6.464,18.022,19213,1.589,36.043,7616,7731,48863
1987,8,69241,82353,1189734,1206490,12973,15.923,11218,13.769,238480,110845,127635,9.187,19.766,273688,95286,178402,7.898,22.685,-35208,-2.918,39.533,7736,7921,50099
1988,8,70292,84167,1205638,1195927,12847,15.469,10612,12.778,235304,100568,134736,8.409,19.675,215284,83235,132049,6.96,18.001,20020,1.674,36.003,7611,7729,45701
1989,8,70820,84773,1225692,1209722,12170,14.541,10011,11.962,231052,89039,142013,7.36,19.1,199575,85283,114292,7.05,16.498,31477,2.602,32.995,7096,7322,47664
1990,8,72344,86539,1264704,1240434,12027,14.147,8973,10.555,233367,91156,142211,7.349,18.813,184665,66079,118586,5.327,14.887,48702,3.926,29.774,6480,6623,39969
1991,8,73784,88839,1289284,1274437,12714,14.607,9112,10.469,229534,91899,137635,7.211,18.011,200114,72647,127467,5.7,15.702,29420,2.308,31.404,6433,6587,44686
1992,8,75520,90690,1333335,1304860,12446,13.97,9249,10.381,255218,98345,156873,7.537,19.559,197567,72634,124933,5.566,15.141,57651,4.418,30.282,6097,6240,40965
1993,8,79440,94318,1396368,1364676,13264,14.36,9368,10.142,260733,88505,172228,6.485,19.106,197553,72601,124952,5.32,14.476,63180,4.63,28.952,6040,6173,33351
1994,8,83504,99170,1462589,1430889,14496,14.988,9594,9.919,270381,101729,168652,7.109,18.896,207481,78441,129040,5.482,14.5,62900,4.396,29,6734,6874,43664
1995,8,87365,103828,1552628,1505480,15024,14.823,10085,9.95,304719,120072,184647,7.976,20.241,209657,73678,135979,4.894,13.926,95062,6.314,27.853,7093,7200,44066
1996,8,89545,106404,1572569,1553116,14716,14.047,11435,10.915,296003,119221,176782,7.676,19.059,258781,103447,155334,6.661,16.662,37222,2.397,33.324,7815,7960,54746
1997,8,91879,109472,1648990,1615545,15801,14.656,12486,11.581,335464,134710,200754,8.338,20.765,268175,106371,161804,6.584,16.6,67289,4.165,33.199,8217,8372,51624
1998,8,94583,113232,1759728,1713858,15699,14.094,12005,10.778,345153,127161,217992,7.42,20.139,253080,90166,162914,5.261,14.767,92073,5.372,29.533,8010,8115,45238
1999,8,96535,116130,1824029,1792634,15628,13.647,12394,10.823,352461,136812,215649,7.632,19.662,289103,112003,177100,6.248,16.127,63358,3.534,32.255,8174,8425,52110
2000,8,98394,118492,1904766,1866740,15628,13.339,12959,11.061,364664,132020,232644,7.072,19.535,286776,116336,170440,6.232,15.362,77888,4.172,30.725,8138,8444,51280
2001,8,100209,121425,1981437,1944244,16547,13.816,13239,11.054,387961,145947,242014,7.507,19.954,315139,113529,201610,5.839,16.209,72822,3.746,32.418,8589,8795,54422
2002,8,100773,122644,1912794,1952131,16597,13.601,15371,12.596,339594,136230,203364,6.979,17.396,419130,140067,279063,7.175,21.47,-79536,-4.074,34.792,9310,9562,66255
2003,8,102329,124382,1892424,1901518,16506,13.379,14482,11.739,314054,120257,193797,6.324,16.516,332101,115832,216269,6.092,17.465,-18047,-0.949,33.032,8904,9050,54256
2004,8,104056,126544,1911324,1900323,16430,13.104,14099,11.245,303806,115142,188664,6.059,15.987,282643,102879,179764,5.414,14.873,21163,1.114,29.747,8979,9127,50816
2005,8,106938,130028,1933591,1923833,17782,13.87,14144,11.032,300002,114681,185321,5.961,15.594,280611,95755,184856,4.977,14.586,19391,1.008,29.172,9084,9233,48695
2006,8,110031,134387,2017124,1975199,20087,15.206,15505,11.738,352807,142043,210764,7.191,17.862,269273,101263,168010,5.127,13.633,83534,4.229,27.265,10532,10675,56504
2007,8,112062,137439,2057750,2038596,18863,13.897,15449,11.382,357630,132296,225334,6.49,17.543,319551,107629,211922,5.28,15.675,38079,1.868,31.35,9801,9911,52030
2008,8,111771,137532,2085082,2070747,16717,12.172,16331,11.891,334746,112896,221850,5.452,16.165,307447,109525,197922,5.289,14.847,27299,1.318,29.694,10574,10727,56052
2009,8,108759,134411,1995625,2042159,14604,10.731,17978,13.21,263160,100322,162838,4.913,12.886,358270,105382,252888,5.16,17.544,-95110,-4.657,25.773,11296,11510,58080
2010,8,106780,132485,1954075,1975338,14805,11.106,16456,12.344,265585,97615,167970,4.942,13.445,307328,93310,214018,4.724,15.558,-41743,-2.113,26.89,10006,10197,47558
2011,8,106482,132566,1980592,1967587,15225,11.5,14887,11.244,281026,90055,190971,4.577,14.283,254803,82238,172565,4.18,12.95,26223,1.333,25.9,9205,9356,43316
2012,8,107469,133328,2030327,2004855,14991,11.29,13895,10.465,292904,92976,199928,4.638,14.61,242868,85918,156950,4.285,12.114,50036,2.496,24.228,8163,8353,41167
2013,8,109001,135059,2094325,2062125,15424,11.508,13367,9.973,306005,95640,210365,4.638,14.839,241308,84304,157004,4.088,11.702,64697,3.137,23.404,8170,8259,43055
2014,8,111078,138035,2176486,2134252,16069,11.778,12871,9.434,326982,108707,218275,5.093,15.321,241990,78399,163591,3.673,11.338,84992,3.982,22.677,8300,8373,40430
2015,8,113273,140908,2253161,2210476,16628,11.934,13489,9.681,328827,106945,221882,4.838,14.876,243355,84750,158605,3.834,11.009,85472,3.867,22.018,8644,8743,44859
2016,8,115927,144960,2312584,2282296,17454,12.22,13189,9.234,321549,117354,204195,5.142,14.089,261618,86483,175135,3.789,11.463,59931,2.626,22.926,8824,8974,47155
2017,8,118087,147335,2367047,2340950,16884,11.563,14255,9.762,342373,117891,224482,5.036,14.625,289739,102030,187709,4.358,12.377,52634,2.248,24.754,9254,9395,51018
2018,8,120207,149354,2423785,2395171,16298,10.995,14058,9.484,324925,105187,219738,4.392,13.566,267788,90244,177544,3.768,11.18,57137,2.386,22.361,10298,10511,55905
1978,9,56201,63917,1158083,1130753,8053,12.812,5932,9.437,201537,59910,141627,5.298,17.823,147231,55490,91741,4.907,13.021,54306,4.803,26.041,3965,4016,20260
1979,9,58003,66014,1237340,1196934,7818,12.078,5248,8.108,203898,65609,138289,5.481,17.035,122950,46508,76442,3.886,10.272,80948,6.763,20.544,3428,3446,18408
1980,9,58160,66558,1271205,1253706,7309,11.07,6243,9.456,184097,62077,122020,4.951,14.684,149258,48687,100571,3.883,11.905,34839,2.779,23.811,4153,4218,21082
1981,9,59014,67659,1279008,1273488,7223,10.804,5616,8.4,173220,66301,106919,5.206,13.602,162120,50697,111423,3.981,12.73,11100,0.872,25.461,3475,3531,16177
1982,9,59300,68219,1282777,1280235,7618,11.256,6540,9.663,179982,66575,113407,5.2,14.059,173791,46597,127194,3.64,13.575,6191,0.484,27.15,4493,4579,22238
1983,9,60781,69836,1284992,1278171,7952,11.6,5386,7.857,184244,61950,122294,4.847,14.415,170964,44298,126666,3.466,13.376,13280,1.039,26.751,3674,3718,18764
1984,9,63481,72806,1360716,1324325,8952,12.618,5227,7.368,224698,73738,150960,5.568,16.967,152720,44512,108208,3.361,11.532,71978,5.435,23.064,3761,3814,21382
1985,9,64954,74472,1407222,1381168,9211,12.586,6635,9.066,224528,71887,152641,5.205,16.256,172427,64935,107492,4.701,12.484,52101,3.772,24.968,4853,4913,33425
1986,9,66681,76399,1434787,1416930,9624,12.849,6632,8.854,220258,81951,138307,5.784,15.545,184319,53430,130889,3.771,13.008,35939,2.536,26.017,4668,4732,27298
1987,9,68951,79266,1468583,1464105,11153,14.415,7362,9.515,254536,95469,159067,6.521,17.385,243002,67489,175513,4.61,16.597,11534,0.788,33.195,5257,5298,36098
1988,9,71848,83013,1511680,1489084,11419,14.093,7443,9.186,268701,112324,156377,7.543,18.045,224486,75674,148812,5.082,15.075,44215,2.969,30.151,5313,5367,31135
1989,9,72997,84525,1518170,1509699,10762,12.924,8260,9.919,235436,89232,146204,5.911,15.595,219085,75915,143170,5.028,14.512,16351,1.083,29.024,6048,6127,36017
1990,9,72310,84241,1492908,1495509,9390,11.191,8718,10.39,210456,78303,132153,5.236,14.073,215838,64689,151149,4.326,14.432,-5382,-0.36,28.145,6516,6629,37776
1991,9,69675,82109,1433814,1457979,8462,10.244,9454,11.445,204189,71579,132610,4.909,14.005,251453,75109,176344,5.152,17.247,-47264,-3.242,28.01,6898,7020,43984
1992,9,68130,80533,1405886,1410288,8061,9.985,8458,10.477,197879,67966,129913,4.819,14.031,207052,61025,146027,4.327,14.682,-9173,-0.65,28.062,5667,5783,31930
1993,9,68357,80572,1392356,1400477,8055,10.013,7807,9.704,200422,59603,140819,4.256,14.311,216839,62684,154155,4.476,15.483,-16417,-1.172,28.622,5156,5256,30031
1994,9,68770,81178,1374897,1382866,8231,10.179,7604,9.403,195763,65083,130680,4.706,14.156,213036,72437,140599,5.238,15.405,-17273,-1.249,28.313,5210,5317,33668
1995,9,69774,82395,1393792,1382327,8653,10.593,7230,8.851,199749,76178,123571,5.511,14.45,176806,55888,120918,4.043,12.79,22943,1.66,25.581,4935,5130,28046
1996,9,69530,82371,1394511,1392112,8053,9.809,7515,9.153,198903,76766,122137,5.514,14.288,195178,67208,127970,4.828,14.02,3725,0.268,28.041,5049,5229,31663
1997,9,69559,82512,1462355,1435516,8542,10.372,8223,9.985,256581,90941,165640,6.335,17.874,201920,76551,125369,5.333,14.066,54661,3.808,28.132,5248,5411,35613
1998,9,69787,82907,1482988,1476860,8008,9.68,7647,9.244,226337,79037,147300,5.352,15.326,215038,73453,141585,4.974,14.56,11299,0.765,29.121,4825,4936,27852
1999,9,69620,83131,1517779,1500721,7751,9.348,7324,8.833,228910,76415,152495,5.092,15.253,193831,70534,123297,4.7,12.916,35079,2.337,25.832,4741,4880,29434
2000,9,69755,83284,1539280,1531019,7564,9.099,7255,8.727,216467,72143,144324,4.712,14.139,199505,71265,128240,4.655,13.031,16962,1.108,26.062,4501,4675,29023
2001,9,69233,83278,1547137,1543340,7743,9.313,7462,8.975,218809,80061,138748,5.188,14.178,210594,72371,138223,4.689,13.645,8215,0.532,27.291,4589,4736,27579
2002,9,68691,83161,1536859,1546272,8304,9.987,8277,9.955,235590,89663,145927,5.799,15.236,254971,86022,168949,5.563,16.489,-19381,-1.253,30.472,4986,5076,36372
2003,9,68275,82565,1537907,1537570,7410,8.95,7861,9.495,216484,66410,150074,4.319,14.08,215816,69267,146549,4.505,14.036,668,0.043,28.072,4700,4772,27731
2004,9,68863,83498,1532610,1533358,7952,9.581,6956,8.381,203250,67308,135942,4.39,13.255,204211,67380,136831,4.394,13.318,-961,-0.063,26.51,4387,4445,24653
2005,9,69261,84118,1524381,1527674,8219,9.813,7502,8.957,185196,73006,112190,4.779,12.123,190798,59444,131354,3.891,12.489,-5602,-0.367,24.245,4632,4696,27169
2006,9,69428,85047,1545508,1532952,8883,10.511,7812,9.244,208050,75333,132717,4.914,13.572,182311,62921,119390,4.105,11.893,25739,1.679,23.786,5329,5431,29629
2007,9,68935,85117,1522447,1534609,8190,9.635,7953,9.357,207123,73171,133952,4.768,13.497,230531,63265,167266,4.123,15.022,-23408,-1.525,26.994,4974,5058,30678
2008,9,68137,84613,1532400,1527802,7502,8.846,7885,9.298,216804,68803,148001,4.503,14.191,209007,59289,149718,3.881,13.68,7797,0.51,27.36,5036,5105,26135
2009,9,66252,82544,1456768,1497875,6279,7.506,8494,10.154,148312,48128,100184,3.213,9.901,229500,61091,168409,4.079,15.322,-81188,-5.42,19.803,5161,5243,31848
2010,9,65077,81335,1427259,1441970,6520,7.963,7600,9.282,153438,50210,103228,3.482,10.641,181951,49039,132912,3.401,12.618,-28513,-1.977,21.282,4577,4679,24456
2011,9,64216,80493,1432704,1429801,6466,7.997,7191,8.894,160328,48077,112251,3.362,11.213,153997,47906,106091,3.351,10.771,6331,0.443,21.541,4430,4503,22593
2012,9,64468,80788,1457707,1445388,7004,8.694,6553,8.134,180487,49312,131175,3.412,12.487,155567,47238,108329,3.268,10.763,24920,1.724,21.526,3878,3948,20918
2013,9,64242,80687,1458639,1457765,6887,8.541,6789,8.419,160611,47540,113071,3.261,11.018,159139,50257,108882,3.448,10.917,1472,0.101,21.833,4083,4142,21425
2014,9,64079,80947,1477874,1468447,6847,8.477,6502,8.05,168317,50948,117369,3.47,11.462,150182,48807,101375,3.324,10.227,18135,1.235,20.455,4111,4151,19723
2015,9,63858,81066,1498954,1489695,6793,8.391,6577,8.124,176183,58408,117775,3.921,11.827,157993,45264,112729,3.038,10.606,18190,1.221,21.211,4075,4134,23567
2016,9,64567,82525,1538573,1518531,7711,9.432,6170,7.547,184192,60877,123315,4.009,12.13,143048,46873,96175,3.087,9.42,41144,2.709,18.84,4098,4147,19947
2017,9,63684,81632,1527703,1526950,6231,7.597,7014,8.551,183865,58222,125643,3.813,12.041,181370,75090,106280,4.918,11.878,2495,0.163,23.756,4448,4549,33823
2018,9,63238,81025,1527131,1526640,6397,7.874,6832,8.409,172551,56039,116512,3.671,11.303,172273,54021,118252,3.539,11.284,278,0.018,22.569,4644,4755,30125
1978,10,9940,11491,218459,214404,1531,13.513,1208,10.662,38945,11727,27218,5.47,18.164,30124,9961,20163,4.646,14.05,8821,4.114,28.1,814,826,5055
1979,10,10291,11888,210207,206346,1559,13.389,1070,9.19,32604,11836,20768,5.736,15.801,24791,8484,16307,4.112,12.014,7813,3.786,24.029,690,707,3425
1980,10,10292,11894,216132,213274,1356,11.452,1249,10.549,31804,11260,20544,5.28,14.912,26189,7393,18796,3.466,12.28,5615,2.633,24.559,880,911,3707
1981,10,10301,11955,220828,218050,1273,10.713,1129,9.501,32065,11478,20587,5.264,14.705,26275,7254,19021,3.327,12.05,5790,2.655,24.1,703,719,2990
1982,10,10340,11978,222786,221679,1394,11.709,1249,10.491,31977,12620,19357,5.693,14.425,30025,8871,21154,4.002,13.544,1952,0.881,27.089,828,846,4327
1983,10,10802,12488,225751,222427,1671,13.764,975,8.031,35301,12869,22432,5.786,15.871,28343,6573,21770,2.955,12.743,6958,3.128,25.485,635,644,3475
1984,10,11181,12912,240572,232049,1726,13.708,1085,8.617,41980,15039,26941,6.481,18.091,24977,6354,18623,2.738,10.764,17003,7.327,21.527,766,771,3588
1985,10,11496,13253,276690,257668,1786,13.761,1237,9.531,69236,36496,32740,14.164,26.87,31935,11084,20851,4.302,12.394,37301,14.476,24.788,834,851,5291
1986,10,11985,13856,283691,279075,2007,14.935,1172,8.721,47171,15795,31376,5.66,16.903,37828,10410,27418,3.73,13.555,9343,3.348,27.11,812,824,4130
1987,10,12387,14387,278274,288740,2157,15.409,1380,9.858,54680,18158,36522,6.289,18.937,73753,13110,25031,4.54,25.543,-19073,-6.606,37.875,933,942,6307
1988,10,13038,15188,296184,287157,2233,15.132,1371,9.291,56994,22078,34916,7.688,19.848,38878,11986,26892,4.174,13.539,18116,6.309,27.078,938,959,6566
1989,10,13600,15939,307322,302008,2320,14.996,1384,8.946,53124,19527,33597,6.466,17.59,42350,12661,29689,4.192,14.023,10774,3.567,28.046,957,983,6931
1990,10,14103,16581,315556,309853,2271,14.039,1461,9.032,48845,15519,33326,5.009,15.764,37290,9880,27410,3.189,12.035,11555,3.729,24.07,1059,1069,5951
1991,10,14266,17044,317822,316850,2320,13.887,1645,9.846,47543,19331,28212,6.101,15.005,45968,10342,35626,3.264,14.508,1575,0.497,29.016,1110,1141,6376
1992,10,14297,17172,307650,309164,2203,12.991,1776,10.473,45232,19060,26172,6.165,14.63,48280,13591,34689,4.396,15.616,-3048,-0.986,29.261,1124,1133,6484
1993,10,14691,17479,310038,308441,2107,12.176,1759,10.165,46874,15826,31048,5.131,15.197,43606,14138,29468,4.584,14.138,3268,1.06,28.275,1048,1068,5958
1994,10,15012,17936,315172,312919,2302,13.005,1832,10.35,50503,19931,30572,6.369,16.139,45686,14910,30776,4.765,14.6,4817,1.539,29.2,1159,1169,7601
1995,10,15478,18505,331091,322784,2386,13.111,1773,9.743,57977,20236,37741,6.269,17.962,40931,15156,25775,4.695,12.681,17046,5.281,25.361,1148,1172,6512
1996,10,15642,18677,331927,330399,2194,11.861,1836,9.925,48555,18624,29931,5.637,14.696,45551,14953,30598,4.526,13.787,3004,0.909,27.573,1174,1210,6857
1997,10,15994,19122,347602,341543,2454,12.995,1977,10.469,60586,21652,38934,6.339,17.739,48881,17555,31326,5.14,14.312,11705,3.427,28.624,1241,1257,8033
1998,10,16473,19709,354824,351840,2448,12.568,1986,10.196,61376,22504,38872,6.396,17.444,54161,19017,35144,5.405,15.394,7215,2.051,30.787,1187,1202,7402
1999,10,16861,20128,364062,359489,2464,12.384,2002,10.062,63832,29438,34394,8.189,17.756,54358,19590,34768,5.449,15.121,9474,2.635,30.242,1191,1220,8024
2000,10,17282,20736,377336,370558,2708,13.261,2077,10.171,70632,31059,39573,8.382,19.061,57572,24746,32826,6.678,15.537,13060,3.524,31.073,1243,1268,6652
2001,10,17636,21275,386566,382242,2630,12.537,2035,9.701,65332,25516,39816,6.675,17.092,56358,17725,38633,4.637,14.744,8974,2.348,29.488,1237,1268,7287
2002,10,17535,21579,383761,386240,2689,12.543,2407,11.228,65321,30870,34451,7.992,16.912,69626,23866,45760,6.179,18.027,-4305,-1.115,33.824,1418,1476,10117
2003,10,17789,21872,381270,382343,2415,11.134,2050,9.452,51482,17780,33702,4.65,13.465,54041,18437,35604,4.822,14.134,-2559,-0.669,26.93,1229,1252,7254
2004,10,18119,22384,391210,386182,2589,11.713,2029,9.179,60611,23798,36813,6.162,15.695,50409,19832,30577,5.135,13.053,10202,2.642,26.106,1250,1274,7299
2005,10,18332,22521,390415,389944,2454,10.938,2283,10.176,54724,18833,35891,4.83,14.034,53598,22777,30821,5.841,13.745,1126,0.289,27.49,1316,1334,9274
2006,10,18352,22692,388140,389303,2731,12.089,2530,11.199,55201,20402,34799,5.241,14.179,57637,22358,35279,5.743,14.805,-2436,-0.626,28.359,1729,1765,9367
2007,10,18133,22762,385838,386896,2603,11.463,2494,10.983,64391,27346,37045,7.068,16.643,66879,23699,43180,6.125,17.286,-2488,-0.643,33.286,1452,1457,8394
2008,10,17841,22471,384653,384822,2263,10.021,2488,11.017,57870,19294,38576,5.014,15.038,57854,16464,41390,4.278,15.034,16,0.004,30.068,1539,1552,7129
2009,10,17374,21989,367535,376922,2003,9.002,2526,11.353,44571,20817,23754,5.523,11.825,63616,18259,45357,4.844,16.878,-19045,-5.053,23.65,1498,1534,7831
2010,10,17154,21645,359172,363388,1948,8.937,2254,10.34,40364,12373,27991,3.405,11.108,48468,14646,33822,4.03,13.338,-8104,-2.23,22.215,1294,1318,5750
2011,10,17036,21545,358687,359187,2020,9.361,2086,9.667,43367,12691,30676,3.533,12.074,44400,13864,30536,3.86,12.361,-1033,-0.288,24.147,1248,1272,5856
2012,10,16917,21544,361396,359805,2109,9.802,2055,9.551,49154,16369,32785,4.549,13.661,46304,17693,28611,4.917,12.869,2850,0.792,25.738,1149,1187,5771
2013,10,16962,21608,371464,366213,2070,9.613,1922,8.925,52599,17656,34943,4.821,14.363,42463,15226,27237,4.158,11.595,10136,2.768,23.19,1075,1087,5123
2014,10,17098,21744,386853,381767,2069,9.555,1890,8.728,54960,14781,40179,3.872,14.396,44598,13371,31227,3.502,11.682,10362,2.714,23.364,1099,1121,5387
2015,10,17294,22002,395001,391120,2225,10.181,1932,8.84,54394,17591,36803,4.498,13.907,46313,15238,31075,3.896,11.841,8081,2.066,23.682,1115,1135,6280
2016,10,17723,22659,402398,398562,2376,10.647,1690,7.573,53852,16514,37338,4.143,13.512,46048,12518,33530,3.141,11.554,7804,1.958,23.107,1118,1137,6228
2017,10,17809,22695,398520,399983,2229,9.839,2150,9.49,53742,15936,37806,3.984,13.436,56286,19939,36347,4.985,14.072,-2544,-0.636,26.872,1307,1326,6076
2018,10,18068,22998,423424,411546,2278,9.982,1926,8.439,67172,24925,42247,6.056,16.322,43581,11945,31636,2.902,10.59,23591,5.732,21.179,1354,1380,6755
1978,11,12722,14599,308323,295496,1946,13.452,1681,11.62,66589,18359,48230,6.213,22.535,42016,16708,25308,5.654,14.219,24573,8.316,28.438,1019,1042,5566
1979,11,13015,14925,329059,315854,1870,12.765,1319,9.004,58655,16521,42134,5.231,18.57,32628,11940,20688,3.78,10.33,26027,8.24,20.66,843,858,5261
1980,11,12876,14800,313887,321445,1767,12.012,1588,10.795,50778,15702,35076,4.885,15.797,64307,34550,29757,10.748,20.006,-13529,-4.209,31.594,1001,1024,7581
1981,11,12948,14871,321427,317559,1702,11.54,1457,9.879,47647,17544,30103,5.525,15.004,40285,14003,26282,4.41,12.686,7362,2.318,25.372,890,903,5969
1982,11,13246,15239,318994,320980,2238,14.952,1695,11.325,54178,25778,28400,8.031,16.879,58118,13160,44958,4.1,18.106,-3940,-1.227,33.758,1128,1141,7777
1983,11,13836,15845,328719,319539,2259,14.68,1345,8.741,68432,31750,36682,9.936,21.416,50199,11853,38346,3.709,15.71,18233,5.706,31.42,885,897,6416
1984,11,13976,16064,341937,333789,2177,13.783,1638,10.371,60309,22029,38280,6.6,18.068,43980,11373,32607,3.407,13.176,16329,4.892,26.352,1146,1158,6123
1985,11,13895,16025,360797,349249,2078,13.04,1899,11.917,76379,22197,54182,6.356,21.87,52696,20906,31790,5.986,15.088,23683,6.781,30.177,1417,1438,11948
1986,11,14059,16347,369578,364526,2130,13.287,1497,9.338,59531,23409,36122,6.422,16.331,49584,13982,35602,3.836,13.602,9947,2.729,27.205,1037,1051,8529
1987,11,14169,16527,387332,377501,2126,13.053,1646,10.106,70460,27037,43423,7.162,18.665,50318,17265,33053,4.573,13.329,20142,5.336,26.658,1084,1101,8298
1988,11,14501,17147,373286,378198,2300,13.684,1621,9.645,60956,21867,39089,5.782,16.117,70867,17294,53573,4.573,18.738,-9911,-2.621,32.235,1103,1112,10986
1989,11,14518,17434,384616,377721,2211,12.881,1672,9.741,65118,20776,44342,5.5,17.24,51485,20000,31485,5.295,13.63,13633,3.609,27.261,1106,1112,8641
1990,11,14264,17262,395863,392329,2010,11.783,1603,9.397,57922,20777,37145,5.296,14.764,50949,14006,36943,3.57,12.986,6973,1.777,25.973,1052,1069,6957
1991,11,14210,17236,377091,385326,2124,12.419,1857,10.858,49293,19840,29453,5.149,12.793,65953,17470,48483,4.534,17.116,-16660,-4.324,25.585,1141,1174,10073
1992,11,14077,17123,395236,387237,1816,10.663,1631,9.577,67775,36290,31485,9.372,17.502,53682,13669,40013,3.53,13.863,14093,3.639,27.726,995,1002,6880
1993,11,14119,17006,390704,389822,1760,10.331,1821,10.689,56102,18808,37294,4.825,14.392,54382,19576,34806,5.022,13.95,1720,0.441,27.901,969,989,6957
1994,11,14293,17239,394195,391736,1848,10.791,1621,9.465,52095,17637,34458,4.502,13.299,46747,15587,31160,3.979,11.933,5348,1.365,23.867,1058,1092,8464
1995,11,14392,17424,391543,392737,1853,10.706,1620,9.36,52155,16436,35719,4.185,13.28,55278,17264,38014,4.396,14.075,-3123,-0.795,26.56,1015,1040,7624
1996,11,14370,17434,362772,373189,1836,10.576,1688,9.724,47125,16889,30236,4.526,12.628,66910,16242,50668,4.352,17.929,-19785,-5.302,25.255,1053,1084,7087
1997,11,14262,17229,368468,365108,1878,10.851,2034,11.752,57611,20529,37082,5.623,15.779,50450,18078,32372,4.951,13.818,7161,1.961,27.636,1146,1203,7146
1998,11,14364,17415,384507,381192,1805,10.414,1640,9.462,57798,20164,37634,5.29,15.162,50983,16093,34890,4.222,13.375,6815,1.788,26.749,906,934,6956
1999,11,14338,17455,391920,388084,1805,10.37,1706,9.801,57343,21323,36020,5.494,14.776,49261,18316,30945,4.72,12.693,8082,2.083,25.387,944,968,7429
2000,11,14395,17624,405389,398423,1768,10.09,1563,8.92,58324,18587,39737,4.665,14.639,44786,12653,32133,3.176,11.241,13538,3.398,22.482,872,880,5712
2001,11,14318,17655,402940,400501,1833,10.453,1593,9.085,60884,21864,39020,5.459,15.202,55495,20187,35308,5.04,13.856,5389,1.346,27.713,890,914,6759
2002,11,14641,18083,413760,413825,2210,12.304,1966,10.946,67766,25443,42323,6.148,16.376,67617,23636,43981,5.712,16.34,149,0.036,32.679,1009,1030,11039
2003,11,14615,18016,412823,412841,1712,9.504,1706,9.471,54997,17102,37895,4.143,13.322,54991,16977,38014,4.112,13.32,6,0.001,26.64,892,901,4801
2004,11,14658,18200,419910,417889,1892,10.462,1661,9.185,57158,18993,38165,4.545,13.678,53032,14084,38948,3.37,12.69,4126,0.987,25.381,939,971,5920
2005,11,14988,18603,424518,422001,2071,11.268,1624,8.836,55146,19602,35544,4.645,13.068,50683,13980,36703,3.313,12.01,4463,1.058,24.02,859,881,5661
2006,11,15312,19164,433502,429631,2284,12.113,1669,8.851,62233,20892,41341,4.863,14.485,54362,15603,38759,3.632,12.653,7871,1.832,25.306,973,984,6425
2007,11,15379,19401,435093,434175,2077,10.788,1782,9.255,69976,21461,48515,4.943,16.117,68498,19531,48967,4.498,15.777,1478,0.34,31.553,939,946,6546
2008,11,15364,19449,442984,438674,1957,10.089,1852,9.548,60439,18979,41460,4.326,13.778,51965,15483,36482,3.53,11.846,8474,1.932,23.692,893,919,4633
2009,11,15323,19608,450271,447228,2038,10.43,1903,9.739,62645,20115,42530,4.498,14.007,57119,15153,41966,3.388,12.772,5526,1.236,25.544,970,984,6015
2010,11,15411,19863,460235,460178,2019,10.246,1702,8.638,55639,18723,36916,4.069,12.091,55118,12814,42304,2.785,11.978,521,0.113,23.955,913,924,5202
2011,11,15575,20039,471458,466072,1935,9.709,1715,8.606,60420,17054,43366,3.659,12.964,49344,13512,35832,2.899,10.587,11076,2.376,21.174,836,844,5177
2012,11,15705,20030,479574,474637,1834,9.169,1780,8.899,65483,17592,47891,3.706,13.796,55432,17891,37541,3.769,11.679,10051,2.118,23.358,802,817,9728
2013,11,15916,20443,486424,482665,2172,10.751,1692,8.375,57426,19282,38144,3.995,11.898,50514,15731,34783,3.259,10.466,6912,1.432,20.931,839,846,5976
2014,11,16077,20713,492767,489150,2000,9.732,1674,8.146,60028,20402,39626,4.171,12.272,52736,14215,38521,2.906,10.781,7292,1.491,21.562,900,914,5774
2015,11,16296,20930,505937,498982,2182,10.497,1896,9.121,73771,26881,46890,5.387,14.784,58942,17814,41128,3.57,11.812,14829,2.972,23.625,940,953,7171
2016,11,16565,21586,518144,512071,2276,10.714,1592,7.494,64532,20196,44336,3.944,12.602,52260,11882,40378,2.32,10.206,12272,2.397,20.411,965,988,5441
2017,11,16692,21774,524968,521179,1987,9.175,1754,8.099,62186,18212,43974,3.494,11.932,55127,19421,35706,3.726,10.577,7059,1.354,21.155,1014,1025,6866
2018,11,16890,21884,538234,531213,1957,8.974,1803,8.268,64545,21938,42607,4.13,12.15,49948,14920,35028,2.809,9.403,14597,2.748,18.805,1101,1128,7518
1978,12,165134,196733,2641610,2517005,36378,19.028,25268,13.217,669018,265577,403441,10.551,26.58,418968,190361,228607,7.563,16.645,250050,9.934,33.291,17737,18027,100573
1979,12,173982,207162,2856663,2746866,35846,17.843,23322,11.609,652630,255119,397511,9.288,23.759,432143,181350,250793,6.602,15.732,220487,8.027,31.464,15743,15951,94662
1980,12,181584,216744,2982065,2916429,36271,17.209,24322,11.54,609298,252041,357257,8.642,20.892,478456,173387,305069,5.945,16.406,130842,4.486,32.811,17991,18267,106774
1981,12,190850,228482,3156983,3063567,37655,17.011,23417,10.579,661248,273483,387765,8.927,21.584,474565,147715,326850,4.822,15.491,186683,6.094,30.981,16101,16356,82336
1982,12,193445,233332,3190212,3172823,37076,16.151,29541,12.868,637317,268748,368569,8.47,20.087,602413,197436,404977,6.223,18.987,34904,1.1,37.973,21491,21745,118782
1983,12,203954,245242,3219607,3189368,40413,17.03,24537,10.34,633480,265141,368339,8.313,19.862,571610,173206,398404,5.431,17.922,61870,1.94,35.845,17345,17642,102101
1984,12,215873,258846,3536449,3366275,43824,17.518,26470,10.581,797837,313682,484155,9.318,23.701,458857,163594,295263,4.86,13.631,338980,10.07,27.262,19565,19860,103177
1985,12,224231,268977,3762296,3626845,46201,17.664,31365,11.992,851877,346169,505708,9.545,23.488,579628,220961,358667,6.092,15.982,272249,7.506,31.963,23315,23748,143489
1986,12,231059,277694,3930257,3821172,46834,17.335,31775,11.761,861974,361522,500452,9.461,22.558,644236,228750,415486,5.986,16.86,217738,5.698,33.719,23379,23762,148310
1987,12,239422,289565,4105459,4000641,50916,18.087,34786,12.357,937014,438414,498600,10.959,23.422,727552,278237,449315,6.955,18.186,209462,5.236,36.372,25168,25539,165956
1988,12,251501,306159,4318195,4211878,53176,17.889,35373,11.9,941911,407791,534120,9.682,22.363,729362,283013,446349,6.719,17.317,212549,5.046,34.634,26319,26823,171185
1989,12,258591,315308,4535257,4415005,51052,16.566,36793,11.939,963151,387950,575201,8.787,21.815,725186,274327,450859,6.214,16.425,237965,5.39,32.851,27092,27774,175120
1990,12,265517,324643,4671230,4600503,51170,16.097,37638,11.84,916918,384179,532739,8.351,19.931,772904,271586,501318,5.903,16.8,144014,3.13,33.601,28561,29318,179305
1991,12,265062,327271,4596028,4622617,49485,15.294,42043,12.994,861282,388274,473008,8.399,18.632,913000,322716,590284,6.981,19.751,-51718,-1.119,37.264,30556,31407,209870
1992,12,268933,330834,4601266,4570396,48481,14.855,39543,12.116,887549,370437,517112,8.105,19.42,825738,312493,513245,6.837,18.067,61811,1.352,36.134,27297,28024,177507
1993,12,278264,339214,4785267,4692449,50318,15.049,40631,12.151,960877,371113,589764,7.909,20.477,774973,316798,458175,6.751,16.515,185904,3.962,33.031,28154,28965,177057
1994,12,285095,347860,4995038,4894288,50655,14.761,41250,12.021,965224,375669,589555,7.676,19.721,761791,294046,467745,6.008,15.565,203433,4.157,31.13,30140,30862,185904
1995,12,290885,355460,5205260,5105950,50457,14.373,41624,11.857,1019349,430590,588759,8.433,19.964,819943,314414,505529,6.158,16.059,199406,3.905,32.117,30448,31310,200583
1996,12,294682,360528,5292433,5231708,50135,14.055,42484,11.91,1007902,405201,602701,7.745,19.265,888811,343875,544936,6.573,16.989,119091,2.276,33.978,30664,31383,200264
1997,12,297222,365512,5439551,5376361,52635,14.526,46295,12.777,1104189,441141,663048,8.205,20.538,975447,413862,561585,7.698,18.143,128742,2.395,36.287,32307,33223,226931
1998,12,301339,370611,5729315,5607652,50279,13.666,44865,12.195,1170006,461806,708200,8.235,20.864,924487,384779,539708,6.862,16.486,245519,4.378,32.972,29658,30646,195982
1999,12,303105,374568,5931642,5836672,50649,13.622,45139,12.14,1184631,411896,772735,7.057,20.296,993223,403996,589227,6.922,17.017,191408,3.279,34.034,30244,31281,206564
2000,12,303818,376090,6158344,6040869,48890,13.053,45816,12.232,1196427,415665,780762,6.881,19.806,959659,414067,545592,6.854,15.886,236768,3.919,31.772,29692,30585,185895
2001,12,307721,382146,6373493,6260039,52176,13.788,44705,11.814,1295607,477596,818011,7.629,20.696,1077214,428899,648315,6.851,17.208,218393,3.489,34.416,28514,29323,176851
2002,12,312930,389984,6281556,6352271,56529,14.659,47840,12.405,1212230,496282,715948,7.813,19.083,1356439,515972,840467,8.123,21.354,-144209,-2.27,38.167,30215,31112,253327
2003,12,322928,400531,6417679,6343574,58712,14.872,47240,11.966,1226614,445203,781411,7.018,19.336,1077236,426779,650457,6.728,16.982,149378,2.355,33.963,30780,31316,187740
2004,12,339257,418722,6618893,6549318,65388,15.975,46556,11.374,1239219,435789,803430,6.654,18.921,1108327,448647,659680,6.85,16.923,130892,1.999,33.846,30877,31622,203242
2005,12,354918,436872,6794349,6714808,68136,15.938,49420,11.56,1226726,483858,742868,7.206,18.269,1067454,391451,676003,5.83,15.897,159272,2.372,31.794,32593,33110,215033
2006,12,369696,455582,7159249,6973636,73224,16.427,53594,12.023,1322228,525720,796508,7.539,18.96,957054,370867,586187,5.318,13.724,365174,5.236,27.448,37821,38355,218936
2007,12,372844,462078,7180570,7182748,67381,14.708,59466,12.98,1222463,483674,738789,6.734,17.019,1234333,452075,782258,6.294,17.185,-11870,-0.165,34.039,40110,40753,241147
2008,12,360839,450605,7027938,7107836,56219,12.331,66805,14.653,1063048,401376,661672,5.647,14.956,1226020,428310,797710,6.026,17.249,-162972,-2.293,29.912,46066,46605,232090
2009,12,346432,435961,6554841,6798438,52266,11.776,67993,15.32,858289,369716,488573,5.438,12.625,1343750,398618,945132,5.863,19.766,-485461,-7.141,25.25,44265,45060,216581
2010,12,343501,432461,6454118,6505350,54146,12.485,56586,13.048,950723,349641,601082,5.375,14.614,1050859,356013,694846,5.473,16.154,-100136,-1.539,29.229,36051,36723,175592
2011,12,346122,435903,6575986,6517064,57203,13.188,52880,12.192,1045022,375136,669886,5.756,16.035,925535,346046,579489,5.31,14.202,119487,1.833,28.403,34233,34986,168900
2012,12,354863,445379,6813002,6694993,57636,13.098,46968,10.673,1108365,402028,706337,6.005,16.555,872437,336242,536195,5.022,13.031,235928,3.524,26.062,29356,30105,203082
2013,12,361051,451921,7028734,6938770,55616,12.413,47849,10.68,1056846,383235,673611,5.523,15.231,876005,314957,561048,4.539,12.625,180841,2.606,25.25,30639,31078,158671
2014,12,367107,460724,7282549,7154542,56889,12.478,47234,10.361,1138068,403864,734204,5.645,15.907,881069,302864,578205,4.233,12.315,256999,3.592,24.63,31637,32173,170049
2015,12,375203,471431,7609161,7448851,58804,12.628,47298,10.157,1154943,403101,751842,5.412,15.505,832226,317096,515130,4.257,11.173,322717,4.332,22.345,31441,32079,177075
2016,12,384631,485561,7854442,7737073,60647,12.684,45838,9.586,1131225,405379,725846,5.239,14.621,899122,332411,566711,4.296,11.621,232103,3,23.242,32323,32797,174301
2017,12,390921,491893,7992634,7888174,58165,11.912,50965,10.437,1168748,375335,793413,4.758,14.816,959969,356271,603698,4.517,12.17,208779,2.647,24.339,34701,35229,191481
2018,12,397533,497966,8219014,8088509,56922,11.511,50032,10.117,1159710,418117,741593,5.169,14.338,896500,325727,570773,4.027,11.084,263210,3.254,22.167,37516,38419,190794
1978,13,82072,99696,1610100,1541846,16191,16.574,12174,12.462,359107,136975,222132,8.884,23.291,222748,92970,129778,6.03,14.447,136359,8.844,28.894,8039,8131,43174
1979,13,84191,102800,1685318,1647520,15530,15.394,11694,11.592,318424,125080,193344,7.592,19.327,242680,92315,150365,5.603,14.73,75744,4.597,29.46,7612,7700,42015
1980,13,84573,104104,1705005,1700907,14196,13.775,12105,11.746,276295,111203,165092,6.538,16.244,266866,88315,178551,5.192,15.69,9429,0.554,31.379,8421,8539,45189
1981,13,86071,106426,1750744,1725252,14412,13.75,11193,10.679,306040,121831,184209,7.062,17.739,255432,77611,177821,4.499,14.805,50608,2.933,29.611,7308,7449,37784
1982,13,85754,106885,1772464,1760162,14345,13.51,12929,12.177,309774,133199,176575,7.567,17.599,284572,86236,198336,4.899,16.167,25202,1.432,32.335,8844,8964,46242
1983,13,89315,110907,1787682,1765055,15802,14.614,10250,9.479,319153,114353,204800,6.479,18.082,273956,87639,186317,4.965,15.521,45197,2.561,31.042,6812,6941,41162
1984,13,95200,117593,1971515,1871804,18448,16.247,10350,9.115,410162,154912,255250,8.276,21.913,211173,73116,138057,3.906,11.282,198989,10.631,22.564,7220,7317,38823
1985,13,99089,121928,2129775,2042579,18645,15.686,12516,10.53,449473,167834,281639,8.217,22.005,274125,107298,166827,5.253,13.421,175348,8.585,26.841,8688,8867,56765
1986,13,101809,125760,2229636,2171421,19151,15.608,13034,10.623,432938,168975,263963,7.782,19.938,316935,107461,209474,4.949,14.596,116003,5.342,29.191,9006,9128,57381
1987,13,104745,130221,2323044,2284326,20204,15.884,14157,11.13,477702,213898,263804,9.364,20.912,400521,132152,268369,5.785,17.533,77181,3.379,35.067,9483,9653,67163
1988,13,109026,136555,2423867,2376537,21024,15.787,14259,10.707,471727,202721,269006,8.53,19.849,377719,137754,239965,5.796,15.894,94008,3.956,31.787,10003,10173,77412
1989,13,111718,140481,2499761,2447538,20800,15.12,14966,10.879,498161,204815,293346,8.368,20.354,394774,134031,260743,5.476,16.129,103387,4.224,32.259,10564,10829,73328
1990,13,113400,143107,2553441,2522060,19591,13.901,15249,10.82,456508,169135,287373,6.706,18.101,394190,133052,261138,5.276,15.63,62318,2.471,31.259,10956,11265,71785
1991,13,112800,143914,2462020,2500986,19307,13.54,16659,11.683,403608,173330,230278,6.93,16.138,479446,173170,306276,6.924,19.17,-75838,-3.032,32.276,11470,11783,106166
1992,13,114525,145514,2520953,2484676,19194,13.356,15596,10.852,456482,172572,283910,6.945,18.372,383019,130567,252452,5.255,15.415,73463,2.957,30.83,9969,10367,68521
1993,13,118544,149189,2607288,2561811,19550,13.288,15417,10.479,459045,164777,294268,6.432,17.919,368712,136513,232199,5.329,14.393,90333,3.526,28.785,9951,10237,67010
1994,13,122289,154114,2728313,2671267,20867,13.768,15756,10.396,483683,185268,298415,6.936,18.107,369351,143942,225409,5.389,13.827,114332,4.28,27.654,10752,10997,76374
1995,13,126484,159810,2895450,2812751,21839,13.935,15663,9.994,539633,210712,328921,7.491,19.185,373970,142736,231234,5.075,13.296,165663,5.89,26.591,10763,11041,73008
1996,13,129727,163987,2951539,2914101,22372,13.867,17070,10.58,517354,198751,318603,6.82,17.753,443615,167907,275708,5.762,15.223,73739,2.53,30.446,11584,11848,79076
1997,13,131994,167394,3033064,2992180,22669,13.705,18705,11.308,575212,215081,360131,7.188,19.224,494226,185509,308717,6.2,16.517,80986,2.707,33.035,12387,12697,91968
1998,13,135219,171952,3202710,3144000,23120,13.628,18515,10.914,605182,236392,368790,7.519,19.249,485250,187827,297423,5.974,15.434,119932,3.815,30.868,11737,12120,82124
1999,13,137433,175095,3329883,3267430,22516,13.001,18712,10.804,610187,225221,384966,6.893,18.675,482809,181359,301450,5.551,14.776,127378,3.898,29.553,11923,12382,86940
2000,13,138523,177190,3421617,3374202,22355,12.715,19599,11.148,612792,222819,389973,6.604,18.161,517675,197842,319833,5.863,15.342,95117,2.819,30.684,12229,12552,85642
2001,13,139874,179782,3428874,3425194,22941,12.879,19636,11.023,567553,221416,346137,6.464,16.57,561478,200850,360628,5.864,16.393,6075,0.177,32.785,12030,12633,90124
2002,13,141431,182108,3365400,3414415,24261,13.42,21605,11.951,564242,236141,328101,6.916,16.525,662872,234025,428847,6.854,19.414,-98630,-2.889,33.051,12691,13107,109268
2003,13,144265,185152,3347451,3353141,23828,12.997,20195,11.015,527357,193720,333637,5.777,15.727,539287,179833,359454,5.363,16.083,-11930,-0.356,31.455,12239,12541,74448
2004,13,148097,189639,3423272,3386545,23796,12.712,18901,10.097,561156,192832,368324,5.694,16.57,488370,169613,318757,5.008,14.421,72786,2.149,28.842,11956,12170,73114
2005,13,152071,194648,3477901,3451424,25202,13.13,19791,10.311,550410,206951,343459,5.996,15.947,498854,168563,330291,4.884,14.454,51556,1.494,28.907,12620,12881,77666
2006,13,157066,201542,3607932,3544183,28545,14.431,21074,10.654,607572,240611,366961,6.789,17.143,482156,176259,305897,4.973,13.604,125416,3.539,27.208,14276,14532,91243
2007,13,160401,206733,3627640,3618788,27427,13.46,21502,10.552,577693,225977,351716,6.245,15.964,558899,189684,369215,5.242,15.444,18794,0.519,30.889,13735,14112,86524
2008,13,158343,205325,3614545,3620118,23806,11.571,24628,11.971,549188,199801,349387,5.519,15.17,561737,194910,366827,5.384,15.517,-12549,-0.347,30.341,16287,16542,92894
2009,13,151897,198754,3397443,3513020,20511,10.148,27232,13.474,431631,182289,249342,5.189,12.287,663728,202287,461441,5.758,18.893,-232097,-6.607,24.573,17646,18068,108328
2010,13,148654,194971,3310478,3350961,19718,10.032,22892,11.646,400769,142866,257903,4.263,11.96,481493,152425,329068,4.549,14.369,-80724,-2.409,23.92,14251,14570,74771
2011,13,147483,194123,3321201,3314811,20554,10.58,20847,10.731,446357,149282,297075,4.503,13.466,432316,150764,281552,4.548,13.042,14041,0.424,26.084,13189,13591,72163
2012,13,148026,194635,3362566,3340475,20966,10.803,19835,10.221,472520,160529,311991,4.806,14.145,426440,158344,268096,4.74,12.766,46080,1.379,25.532,11746,11981,65852
2013,13,149082,195842,3435468,3397299,20409,10.472,18518,9.501,465748,139826,325922,4.116,13.709,390229,140785,249444,4.144,11.486,75519,2.223,22.973,11280,11462,65642
2014,13,150383,198608,3512317,3472604,21036,10.68,17761,9.017,475356,147919,327437,4.26,13.689,393861,145134,248727,4.179,11.342,81495,2.347,22.684,11456,11664,83490
2015,13,152506,201811,3666922,3595298,21511,10.759,17777,8.891,535875,177793,358082,4.945,14.905,392588,132456,260132,3.684,10.919,143287,3.985,21.839,11238,11534,71407
2016,13,155474,206357,3790165,3734862,22059,10.82,17106,8.39,501593,169311,332282,4.533,13.43,390954,131357,259597,3.517,10.468,110639,2.962,20.935,11450,11721,70804
2017,13,157738,209150,3869830,3824966,21639,10.427,18392,8.862,550712,180117,370595,4.709,14.398,459010,152657,306353,3.991,12,91702,2.397,24.001,12083,12351,72525
2018,13,159708,210847,3972149,3925914,20684,9.861,18515,8.827,539025,164385,374640,4.187,13.73,446180,144785,301395,3.688,11.365,92845,2.365,22.73,13282,13686,76048
1978,15,15715,18888,282385,271853,3091,16.805,2101,11.423,62655,26540,36115,9.763,23.047,41556,17857,23699,6.569,15.286,21099,7.761,30.572,1325,1345,7113
1979,15,16600,20034,303823,293801,3138,16.189,1837,9.477,58206,21407,36799,7.286,19.811,38143,13742,24401,4.677,12.983,20063,6.829,25.965,1170,1190,7444
1980,15,17341,20969,313520,308246,3132,15.359,1978,9.7,54343,22312,32031,7.238,17.63,44009,13464,30545,4.368,14.277,10334,3.353,28.554,1390,1422,7811
1981,15,17919,21641,321182,316878,3017,14.245,2094,9.887,56221,22949,33272,7.242,17.742,47600,13812,33788,4.359,15.022,8621,2.721,30.043,1360,1409,7277
1982,15,17839,21692,313745,316708,2822,13.107,2499,11.607,52727,23844,28883,7.529,16.648,58431,16253,42178,5.132,18.45,-5704,-1.801,33.297,1737,1757,10584
1983,15,18623,22520,310310,310008,3167,14.444,1980,9.03,52069,22304,29765,7.195,16.796,51433,17885,33548,5.769,16.591,636,0.205,33.182,1329,1368,10174
1984,15,18970,22917,320222,314115,2950,13.086,2204,9.776,56121,21911,34210,6.975,17.866,43979,14576,29403,4.64,14.001,12142,3.865,28.002,1493,1565,9164
1985,15,19031,22980,352069,334821,2813,12.353,2397,10.526,80778,46724,34054,13.955,24.126,48182,19280,28902,5.758,14.39,32596,9.735,28.781,1643,1694,10510
1986,15,19211,23376,368701,358575,2979,12.974,2149,9.359,65437,25304,40133,7.057,18.249,45099,13916,31183,3.881,12.577,20338,5.672,25.155,1429,1450,7627
1987,15,19639,23978,364224,367850,3365,14.329,2376,10.118,79628,32176,47452,8.747,21.647,85861,18515,67346,5.033,23.341,-6233,-1.694,43.294,1533,1582,10598
1988,15,20478,25105,383988,374734,3523,14.378,2318,9.46,71729,29646,42083,7.911,19.141,53460,18995,34465,5.069,14.266,18269,4.875,28.532,1585,1636,9246
1989,15,20950,25841,410231,395968,3335,13.168,2307,9.109,76281,29868,46413,7.543,19.264,47508,16889,30619,4.265,11.998,28773,7.267,23.996,1669,1698,11156
1990,15,21609,26690,432182,419204,3459,13.243,2316,8.867,77130,30525,46605,7.282,18.399,50598,17994,32604,4.292,12.07,26532,6.329,24.14,1598,1646,10047
1991,15,21934,27518,436705,434444,3620,13.421,2530,9.38,75259,31689,43570,7.294,17.323,70976,21377,49599,4.921,16.337,4283,0.986,32.674,1758,1807,13596
1992,15,21884,27608,443465,438516,3024,11.049,2545,9.299,72120,24269,47851,5.534,16.446,61865,17348,44517,3.956,14.108,10255,2.339,28.216,1681,1706,9980
1993,15,21859,27477,434520,438600,2926,10.641,2968,10.794,64770,25457,39313,5.804,14.767,72331,21882,50449,4.989,16.491,-7561,-1.724,29.535,1927,1970,10902
1994,15,21819,27432,427850,431732,2837,10.337,2862,10.428,60357,25477,34880,5.901,13.98,68396,23663,44733,5.481,15.842,-8039,-1.862,27.96,1973,2055,17084
1995,15,21913,27626,423167,424037,2909,10.582,2638,9.596,55727,22625,33102,5.336,13.142,57854,17911,39943,4.224,13.644,-2127,-0.502,26.284,1813,1857,10027
1996,15,21734,27351,415687,417201,2802,10.232,2868,10.473,60689,27650,33039,6.628,14.547,63637,21305,42332,5.107,15.253,-2948,-0.707,29.093,1847,1953,10222
1997,15,21668,27222,418618,418281,2844,10.434,2916,10.698,61037,21370,39667,5.109,14.592,60125,20541,39584,4.911,14.374,912,0.218,28.749,1866,1922,10789
1998,15,21679,27131,410668,414040,2647,9.735,2768,10.18,56967,21999,34968,5.313,13.759,63471,22824,40647,5.513,15.33,-6504,-1.571,27.518,1705,1743,9692
1999,15,21567,26966,415506,413637,2573,9.526,2662,9.855,59057,24099,34958,5.826,14.277,55453,20434,35019,4.94,13.406,3604,0.871,26.812,1651,1722,10720
2000,15,21770,27136,430743,423304,2615,9.681,2368,8.766,62867,21953,40914,5.186,14.852,47879,20161,27718,4.763,11.311,14988,3.541,22.622,1452,1502,8412
2001,15,22076,27546,439363,434776,2794,10.225,2351,8.604,61396,23367,38029,5.374,14.121,52514,18893,33621,4.345,12.078,8882,2.043,24.157,1403,1453,7972
2002,15,22234,27844,439877,442079,3066,11.064,2803,10.115,66660,27917,38743,6.315,15.079,70858,23678,47180,5.356,16.028,-4198,-0.95,30.158,1653,1695,12434
2003,15,22644,28228,457985,448623,2892,10.328,2440,8.714,70485,21173,49312,4.72,15.711,51438,19900,31538,4.436,11.466,19047,4.246,22.932,1460,1509,10032
2004,15,23072,28772,471346,464552,2842,9.978,2265,7.952,63258,19558,43700,4.21,13.617,50014,14881,35133,3.203,10.766,13244,2.851,21.532,1459,1496,8177
2005,15,23550,29469,487909,479518,3058,10.508,2321,7.976,71587,26955,44632,5.621,14.929,54535,16489,38046,3.439,11.373,17052,3.556,22.746,1490,1550,8054
2006,15,24163,30513,509636,498610,3554,11.858,2470,8.241,77036,29491,47545,5.915,15.45,54918,17471,37447,3.504,11.014,22118,4.436,22.028,1709,1738,9890
2007,15,24312,30705,516403,512956,3056,9.997,2785,9.11,76261,24917,51344,4.858,14.867,69488,25010,44478,4.876,13.547,6773,1.32,27.093,1669,1730,12008
2008,15,23983,30414,515953,516167,2624,8.597,2841,9.308,66679,21117,45562,4.091,12.918,67572,20548,47024,3.981,13.091,-893,-0.173,25.836,1829,1882,10762
2009,15,23553,29973,485216,500911,2533,8.385,3008,9.957,49130,19134,29996,3.82,9.808,81073,21357,59716,4.264,16.185,-31943,-6.377,19.616,1900,1958,12734
2010,15,23110,29597,477353,481131,2383,8.008,2704,9.087,56287,20855,35432,4.335,11.699,63916,17454,46462,3.628,13.285,-7629,-1.586,23.398,1693,1740,8922
2011,15,22794,29348,482168,479334,2385,8.102,2561,8.7,56400,19379,37021,4.043,11.766,50923,16789,34134,3.503,10.624,5477,1.143,21.247,1597,1641,8713
2012,15,22674,29119,489076,485461,2281,7.813,2435,8.34,58384,16870,41514,3.475,12.027,50698,15912,34786,3.278,10.443,7686,1.583,20.887,1370,1400,7475
2013,15,22727,29198,501425,495212,2477,8.505,2327,7.99,60637,19159,41478,3.869,12.245,48186,19188,28998,3.875,9.73,12451,2.514,19.461,1360,1407,10055
2014,15,22715,29409,518292,509726,2456,8.389,2192,7.487,62983,23116,39867,4.535,12.356,46253,14454,31799,2.836,9.074,16730,3.282,18.148,1449,1466,7925
2015,15,22745,29541,524232,521103,2462,8.36,2277,7.732,56176,17195,38981,3.3,10.78,50460,15909,34551,3.053,9.683,5716,1.097,19.367,1481,1500,9276
2016,15,22994,29984,529815,526985,2627,8.831,2156,7.247,58674,18648,40026,3.539,11.134,52609,13125,39484,2.491,9.983,6065,1.151,19.966,1420,1483,8110
2017,15,23005,30073,542244,535846,2490,8.3,2346,7.82,71863,27804,44059,5.189,13.411,59172,15655,43517,2.922,11.043,12691,2.368,22.085,1547,1571,8164
2018,15,23119,30208,550567,546854,2428,8.061,2252,7.477,61065,18384,42681,3.362,11.167,53105,15831,37274,2.895,9.711,7960,1.456,19.422,1644,1692,11040
1978,16,17181,19866,238311,228038,3625,18.755,2550,13.193,60372,24696,35676,10.83,26.475,40070,16387,23683,7.186,17.572,20302,8.903,35.143,1738,1756,8171
1979,16,17711,20521,245695,242239,3251,16.164,2434,12.102,49185,19617,29568,8.098,20.304,42471,15708,26763,6.485,17.533,6714,2.772,35.065,1763,1775,8787
1980,16,17651,20474,244438,244730,2968,14.543,2836,13.897,44576,18244,26332,7.455,18.214,44385,16258,28127,6.643,18.136,191,0.078,36.273,1994,2020,9669
1981,16,17452,20366,242057,242981,2672,13.16,2547,12.545,39855,15989,23866,6.58,16.403,41922,14445,27477,5.945,17.253,-2067,-0.851,32.805,1753,1787,8370
1982,16,17097,20174,232785,236058,2857,14.175,2820,13.991,39940,18455,21485,7.818,16.92,46511,14532,31979,6.156,19.703,-6571,-2.784,33.839,1954,1966,8440
1983,16,17552,20622,235050,233094,2885,14.256,2114,10.446,43595,19589,24006,8.404,18.703,39616,13840,25776,5.938,16.996,3979,1.707,33.992,1451,1480,7486
1984,16,18407,21548,248644,241241,3234,15.444,2019,9.642,47269,16640,30629,6.898,19.594,32730,11834,20896,4.905,13.567,14539,6.027,27.135,1491,1503,7360
1985,16,18550,21729,251782,248590,3105,14.458,2599,12.102,45520,16743,28777,6.735,18.311,38961,14958,24003,6.017,15.673,6559,2.638,31.346,1880,1913,10237
1986,16,18541,21764,255230,252781,2984,13.842,2572,11.931,45764,17420,28344,6.891,18.104,41122,13809,27313,5.463,16.268,4642,1.836,32.536,1814,1835,9297
1987,16,18567,21768,254776,258497,2991,13.87,2583,11.978,48151,20313,27838,7.858,18.627,56047,16470,39577,6.371,21.682,-7896,-3.055,37.255,1729,1761,10668
1988,16,18966,22382,268867,261345,3045,13.821,2344,10.639,55859,23765,32094,9.093,21.374,40856,15984,24872,6.116,15.633,15003,5.741,31.266,1645,1666,10890
1989,16,19369,22872,291684,279859,2989,13.278,2266,10.066,61629,23945,37684,8.556,22.021,37802,13835,23967,4.944,13.508,23827,8.514,27.015,1575,1617,9154
1990,16,20429,24051,308163,299491,3411,14.607,2013,8.62,58859,20505,38354,6.847,19.653,41837,13582,28255,4.535,13.969,17022,5.684,27.939,1468,1493,8855
1991,16,20770,24642,311399,308905,3150,13.006,2304,9.513,56170,20817,35353,6.739,18.184,50904,19516,31388,6.318,16.479,5266,1.705,32.958,1608,1631,9535
1992,16,21457,25404,325327,317349,3297,13.264,2201,8.855,60447,21496,38951,6.774,19.047,44476,13586,30890,4.281,14.015,15971,5.033,28.03,1470,1506,7818
1993,16,22314,26264,339138,331634,3366,13.069,2350,9.124,58938,20786,38152,6.268,17.772,44146,14920,29226,4.499,13.312,14792,4.46,26.623,1513,1545,8919
1994,16,23621,27750,363211,351601,3932,14.564,2428,8.993,68368,23507,44861,6.686,19.445,45153,15113,30040,4.298,12.842,23215,6.603,25.684,1651,1687,9669
1995,16,24630,28836,374738,368667,3854,13.645,2673,9.463,64098,22117,41981,5.999,17.386,51982,20171,31811,5.471,14.1,12116,3.286,28.2,1856,1884,8860
1996,16,25311,29637,384973,377854,4016,13.795,2966,10.188,71504,26179,45325,6.928,18.924,57677,20534,37143,5.434,15.264,13827,3.659,30.529,2033,2058,11111
1997,16,26065,30527,395722,390402,4361,14.516,3393,11.294,73668,27255,46413,6.981,18.87,63604,24566,39038,6.292,16.292,10064,2.578,32.584,2241,2287,13467
1998,16,26653,31307,423317,413141,4069,13.163,3279,10.608,80657,32537,48120,7.876,19.523,59959,19459,40500,4.71,14.513,20698,5.01,29.026,2237,2257,11142
1999,16,27208,32257,437082,430293,4190,13.207,3125,9.85,72175,29187,42988,6.783,16.773,58401,23100,35301,5.368,13.572,13774,3.201,27.145,2142,2176,14468
2000,16,27519,32649,452913,447423,3964,12.243,3419,10.56,82674,34411,48263,7.691,18.478,71238,23581,47657,5.27,15.922,11436,2.556,31.844,2195,2270,12880
2001,16,27805,32992,463722,458359,4207,12.84,3755,11.46,80527,30269,50258,6.604,17.569,70596,25032,45564,5.461,15.402,9931,2.167,30.804,2236,2308,13697
2002,16,28109,33565,452029,458032,4447,13.389,3746,11.278,81832,34139,47693,7.453,17.866,93255,30538,62717,6.667,20.36,-11423,-2.494,35.732,2238,2289,17821
2003,16,29028,34594,464169,457860,4594,13.508,3427,10.076,77363,26813,50550,5.856,16.897,65347,21203,44144,4.631,14.272,12016,2.624,28.545,2162,2203,9994
2004,16,30078,35722,483593,473711,4620,13.161,3382,9.635,84213,38780,45433,8.186,17.777,64171,22726,41445,4.797,13.546,20042,4.231,27.093,2100,2127,11371
2005,16,31716,37573,513802,499205,5364,14.644,3479,9.498,92036,36526,55510,7.317,18.437,62500,19827,42673,3.972,12.52,29536,5.917,25.04,2284,2318,13087
2006,16,33810,40026,541525,527467,6655,17.186,4048,10.454,96804,37386,59418,7.088,18.353,68994,26119,42875,4.952,13.08,27810,5.272,26.161,2953,2980,18994
2007,16,35076,41615,545640,543293,5827,14.303,4077,10.007,93412,35008,58404,6.444,17.194,88984,25397,63587,4.675,16.379,4428,0.815,32.757,2788,2813,15989
2008,16,34419,41150,534705,539497,4718,11.423,5025,12.166,73562,26980,46582,5.001,13.635,83735,24735,59000,4.585,15.521,-10173,-1.886,27.271,3501,3548,15613
2009,16,32523,39289,498494,516808,3703,9.209,5546,13.792,57150,23206,33944,4.49,11.058,93425,27109,66316,5.245,18.077,-36275,-7.019,22.117,3644,3688,16953
2010,16,31807,38573,488924,493524,3960,10.186,4571,11.757,62009,20959,41050,4.247,12.565,71217,19384,51833,3.928,14.43,-9208,-1.866,25.129,2943,3008,12101
2011,16,30990,37791,481441,484743,3797,9.965,4422,11.605,59848,19332,40516,3.988,12.346,66052,20791,45261,4.289,13.626,-6204,-1.28,24.693,2757,2847,13112
2012,16,31077,37829,493686,487375,3929,10.409,3761,9.964,70399,22930,47469,4.705,14.445,57492,21527,35965,4.417,11.796,12907,2.648,23.593,2287,2325,10130
2013,16,31305,38083,504651,499267,3943,10.409,3540,9.345,69482,18857,50625,3.777,13.917,58670,24288,34382,4.865,11.751,10812,2.166,23.502,2292,2309,11072
2014,16,31995,39000,529236,516055,4195,10.903,3147,8.179,76874,22493,54381,4.359,14.896,50967,15045,35922,2.915,9.876,25907,5.02,19.753,2093,2134,8844
2015,16,32541,39788,547420,538507,4179,10.618,3317,8.428,71601,21535,50066,3.999,13.296,54141,19014,35127,3.531,10.054,17460,3.242,20.108,2211,2243,10011
2016,16,33242,40737,564017,555274,4401,10.944,3353,8.338,76373,24851,51522,4.475,13.754,58923,17983,40940,3.239,10.612,17450,3.143,21.223,2290,2346,10076
2017,16,33776,41346,577143,569731,4331,10.57,3587,8.754,78684,24060,54624,4.223,13.811,63969,20200,43769,3.546,11.228,14715,2.583,22.456,2384,2427,10917
2018,16,34946,42647,596092,586371,4727,11.266,3348,7.98,84708,28678,56030,4.891,14.446,64836,20686,44150,3.528,11.057,19872,3.389,22.114,2520,2593,11972
1978,17,179042,209276,4032692,3927526,27588,13.35,22328,10.805,734045,246275,487770,6.27,18.69,522686,206942,315744,5.269,13.308,211359,5.381,26.617,14977,15230,85843
1979,17,181321,212336,4189759,4112692,25574,12.197,20245,9.656,710605,230323,480282,5.6,17.278,552351,192448,359903,4.679,13.43,158254,3.848,26.861,13112,13366,76844
1980,17,179543,211566,4095148,4137299,24107,11.438,22492,10.672,566923,217121,349802,5.248,13.703,653527,196995,456532,4.761,15.796,-86604,-2.093,27.405,15091,15302,86200
1981,17,180626,213450,4018847,4052849,23828,11.273,19660,9.301,544736,217143,327593,5.358,13.441,612486,158814,453672,3.919,15.112,-67750,-1.672,26.882,12632,12890,73451
1982,17,179539,213055,3937725,3974538,24402,11.502,22607,10.656,572538,254060,318478,6.392,14.405,646210,182773,463437,4.599,16.259,-73672,-1.854,28.81,15406,15796,80629
1983,17,183001,216781,3860707,3864138,25528,11.978,18226,8.552,608491,238142,370349,6.163,15.747,616421,154464,461957,3.997,15.952,-7930,-0.205,31.494,12244,12533,71661
1984,17,186403,220828,4013813,3921040,27276,12.546,20446,9.404,678874,228747,450127,5.834,17.314,490220,174182,316038,4.442,12.502,188654,4.811,25.005,14683,14910,88998
1985,17,187444,222195,4084421,4022056,26837,12.221,21656,9.861,703189,267022,436167,6.639,17.483,581526,214759,366767,5.34,14.458,121663,3.025,28.917,15404,15771,103044
1986,17,189198,224907,4171298,4109298,26898,12.138,20270,9.147,678973,238220,440753,5.797,16.523,556639,180597,376042,4.395,13.546,122334,2.977,27.092,14320,14538,92304
1987,17,190444,227416,4172088,4167914,28730,12.814,22325,9.957,693205,264882,428323,6.355,16.632,684577,232190,452387,5.571,16.425,8628,0.207,32.85,15046,15319,94180
1988,17,195784,235138,4365865,4277582,29000,12.554,20729,8.973,752683,271113,481570,6.338,17.596,576361,195612,380749,4.573,13.474,176322,4.122,26.948,14341,14612,93917
1989,17,199084,240239,4510965,4426133,29170,12.348,21147,8.952,747291,281199,466092,6.353,16.884,577504,186508,390996,4.214,13.048,169787,3.836,26.095,14629,15070,95411
1990,17,203005,245283,4637891,4567598,28131,11.646,20660,8.553,700564,238613,461951,5.224,15.338,559644,165364,394280,3.62,12.252,140920,3.085,24.505,14871,15189,97129
1991,17,202886,247662,4585589,4602271,28039,11.442,22817,9.311,653509,255582,397927,5.553,14.2,688046,212463,475583,4.616,14.95,-34537,-0.75,28.399,16132,16534,129693
1992,17,203687,249205,4576181,4565238,26967,10.921,22404,9.073,698005,234115,463890,5.128,15.29,675675,207708,467967,4.55,14.8,22330,0.489,29.601,14615,14988,109193
1993,17,207298,252562,4640074,4620287,26801,10.695,22854,9.12,696519,231815,464704,5.017,15.075,656319,196392,459927,4.251,14.205,40200,0.87,28.41,15031,15458,92678
1994,17,210808,257065,4758344,4705231,27719,10.879,23169,9.093,715903,239868,476035,5.098,15.215,609549,223381,386168,4.748,12.955,106354,2.26,25.909,15829,16185,118224
1995,17,214931,262536,4909630,4833491,29012,11.181,22899,8.825,759823,272465,487358,5.637,15.72,607134,196444,410690,4.064,12.561,152689,3.159,25.122,15456,15841,101844
1996,17,216243,264914,4893084,4876468,28479,10.832,24486,9.313,707972,246769,461203,5.06,14.518,676153,206299,469854,4.231,13.866,31819,0.653,27.731,16714,17165,101916
1997,17,217455,266403,4999750,4955378,29071,10.954,27029,10.185,801825,276060,525765,5.571,16.181,713734,253215,460519,5.11,14.403,88091,1.778,28.806,17422,17951,121226
1998,17,220301,270681,5184154,5120108,27994,10.42,23921,8.904,796817,258855,537962,5.056,15.563,666836,215516,451320,4.209,13.024,129981,2.539,26.048,15567,15952,98347
1999,17,220816,272261,5300883,5251330,26953,9.941,24698,9.109,778781,254287,524494,4.842,14.83,677971,232195,445776,4.422,12.91,100810,1.92,25.821,15831,16311,104671
2000,17,221153,273617,5414902,5356443,27295,10.011,25388,9.311,850505,265856,584649,4.963,15.878,732411,274669,457742,5.128,13.673,118094,2.205,27.347,15938,16416,112624
2001,17,220331,273655,5371155,5396118,26621,9.741,25913,9.481,756424,268909,487515,4.983,14.018,808761,261569,547192,4.847,14.988,-52337,-0.97,28.036,16310,16894,110936
2002,17,218828,273438,5167313,5281633,29589,10.822,29550,10.808,782976,311133,471843,5.891,14.825,1014578,345929,668649,6.55,19.21,-231602,-4.385,29.649,17337,18074,173582
2003,17,220133,275164,5179310,5170112,28399,10.364,26114,9.53,755898,241245,514653,4.666,14.621,737824,245094,492730,4.741,14.271,18074,0.35,28.542,15738,16091,109979
2004,17,222957,278213,5204404,5191886,28774,10.407,25303,9.152,726450,224426,502024,4.323,13.992,699495,223606,475889,4.307,13.473,26955,0.519,26.946,15559,16278,103895
2005,17,225325,281546,5218323,5209387,30301,10.837,26402,9.443,711547,258700,452847,4.966,13.659,692957,214789,478168,4.123,13.302,18590,0.357,26.604,16492,16904,104003
2006,17,228423,286781,5346741,5284307,32797,11.558,26775,9.435,786709,280240,506469,5.303,14.888,663479,225399,438080,4.265,12.556,123230,2.332,25.111,17569,17915,116978
2007,17,229071,288703,5349123,5348336,30847,10.736,28073,9.771,774244,264688,509556,4.949,14.476,772174,245015,527159,4.581,14.438,2070,0.039,28.875,17398,17684,111802
2008,17,226810,287403,5390617,5367626,28381,9.862,29124,10.12,743350,221494,521856,4.126,13.849,700056,221353,478703,4.124,13.042,43294,0.807,26.084,18697,18988,105381
2009,17,221525,281353,5064364,5233128,24827,8.724,31309,11.001,529995,189556,340439,3.622,10.128,866398,237117,629281,4.531,16.556,-336403,-6.428,20.255,19402,19772,120954
2010,17,218646,278521,4941024,5010856,25455,9.101,27813,9.944,539938,190791,349147,3.808,10.775,680866,191267,489599,3.817,13.588,-140928,-2.812,21.551,16727,17046,97526
2011,17,218236,278609,5023110,4982440,26914,9.67,26323,9.458,619661,186320,433341,3.74,12.437,537509,169444,368065,3.401,10.788,82152,1.649,21.576,16301,16802,84472
2012,17,219268,279012,5092787,5056047,26542,9.531,25475,9.148,662154,194023,468131,3.837,13.096,588029,200400,387629,3.964,11.63,74125,1.466,23.26,14877,15414,82663
2013,17,219113,279097,5157562,5123167,26210,9.404,25428,9.124,636280,195520,440760,3.816,12.42,568975,188453,380522,3.678,11.106,67305,1.314,22.212,15451,15741,95903
2014,17,219172,280205,5253063,5204699,25914,9.274,24356,8.716,633453,189137,444316,3.634,12.171,536137,179404,356733,3.447,10.301,97316,1.87,20.602,15356,15619,82528
2015,17,220614,282390,5366146,5293331,26527,9.438,23891,8.5,711040,203508,507532,3.845,13.433,562767,179449,383318,3.39,10.632,148273,2.801,21.263,14941,15345,83463
2016,17,222317,285459,5417935,5394021,26757,9.431,23256,8.197,653376,208941,444435,3.874,12.113,608716,170082,438634,3.153,11.285,44660,0.828,22.57,15641,15997,85144
2017,17,222121,285334,5402963,5403446,25463,8.93,25095,8.801,658375,194343,464032,3.597,12.184,659871,230659,429212,4.269,12.212,-1496,-0.028,24.369,16196,16691,112317
2018,17,221826,284633,5464410,5436957,23575,8.279,23839,8.371,650659,195450,455209,3.595,11.967,593661,169864,423797,3.124,10.919,56998,1.048,21.838,17255,17736,92378
1978,18,81323,97526,1764433,1714132,13038,13.565,10211,10.624,310846,101522,209324,5.923,18.134,210865,83649,127216,4.88,12.302,99981,5.833,24.603,6669,6757,33821
1979,18,83135,100018,1863893,1817586,12182,12.374,9040,9.183,296859,97117,199742,5.343,16.333,204683,75459,129224,4.152,11.261,92176,5.071,22.523,6236,6324,32635
1980,18,82272,99775,1794053,1829431,10971,11.02,10538,10.585,232475,98856,133619,5.404,12.708,304594,75313,229281,4.117,16.65,-72119,-3.942,25.415,7296,7417,36810
1981,18,81920,99841,1747792,1769062,10249,10.31,9392,9.448,213301,85457,127844,4.831,12.057,254901,69950,184951,3.954,14.409,-41600,-2.352,24.115,6188,6324,30701
1982,18,81514,99757,1693518,1717804,11140,11.213,10329,10.396,222769,88559,134210,5.155,12.968,272714,73923,198791,4.303,15.876,-49945,-2.907,25.936,7043,7225,34893
1983,18,82508,100689,1657257,1671582,12094,12.173,9420,9.481,236746,94321,142425,5.643,14.163,264814,66658,198156,3.988,15.842,-28068,-1.679,28.326,6579,6704,32970
1984,18,85697,104156,1767719,1709011,14392,14.073,10614,10.379,325933,118304,207629,6.922,19.071,208521,90612,117909,5.302,12.201,117412,6.87,24.403,8002,8135,46135
1985,18,86467,105295,1843126,1796006,13106,12.632,10022,9.659,334236,147180,187056,8.195,18.61,237886,85531,152355,4.762,13.245,96350,5.365,26.491,7136,7311,45847
1986,18,87469,106581,1881266,1855692,12997,12.372,9930,9.453,302554,121231,181323,6.533,16.304,252052,89344,162708,4.815,13.583,50502,2.721,27.165,6786,6929,43531
1987,18,88952,108812,1930299,1905914,13835,12.936,10110,9.453,338198,130364,207834,6.84,17.745,292676,95652,197024,5.019,15.356,45522,2.388,30.712,6963,7062,46228
1988,18,91525,112585,2011427,1969975,13884,12.557,9847,8.906,339963,127374,212589,6.466,17.257,257735,87314,170421,4.432,13.083,82228,4.174,26.166,6867,7007,49799
1989,18,93417,115454,2111621,2058929,13778,12.145,9766,8.608,349578,127253,222325,6.181,16.979,245084,88466,156618,4.297,11.903,104494,5.075,23.807,6968,7157,47090
1990,18,95173,118018,2154498,2129449,13446,11.57,9833,8.461,312799,109502,203297,5.142,14.689,262057,77683,184374,3.648,12.306,50742,2.383,24.613,7226,7422,45738
1991,18,95187,119518,2111441,2125233,13373,11.316,10694,9.049,292721,118075,174646,5.556,13.774,321412,97211,224201,4.574,15.124,-28691,-1.35,27.547,7662,7860,60586
1992,18,95872,120798,2172241,2148232,12836,10.74,10268,8.591,357472,132388,225084,6.163,16.64,311582,93816,217766,4.367,14.504,45890,2.136,29.008,6916,7080,46401
1993,18,98020,122864,2223743,2196551,12809,10.532,10323,8.488,328561,101006,227555,4.598,14.958,275723,91109,184614,4.148,12.553,52838,2.405,25.105,6909,7101,43903
1994,18,100203,125711,2281927,2256926,13404,10.79,10435,8.4,333971,109823,224148,4.866,14.798,283854,100456,183398,4.451,12.577,50117,2.221,25.154,7192,7482,51193
1995,18,102412,128977,2382289,2331547,14355,11.29,10695,8.412,366259,130738,235521,5.607,15.709,265179,87023,178156,3.732,11.374,101080,4.335,22.747,7485,7738,45666
1996,18,103135,130336,2377035,2368986,13682,10.587,11486,8.887,343068,130202,212866,5.496,14.482,326286,103919,222367,4.387,13.773,16782,0.708,27.546,7914,8156,50824
1997,18,103568,131397,2436924,2412908,14233,10.893,12769,9.772,384476,125049,259427,5.183,15.934,337220,116454,220766,4.826,13.976,47256,1.958,27.951,8442,8730,59791
1998,18,104561,133053,2534155,2503550,13492,10.205,11800,8.925,381812,135056,246756,5.395,15.251,319638,106350,213288,4.248,12.767,62174,2.483,25.535,7694,7898,49548
1999,18,104326,133482,2584920,2561344,12644,9.501,11839,8.896,372484,125030,247454,4.881,14.543,325115,108039,217076,4.218,12.693,47369,1.849,25.386,7965,8211,56035
2000,18,103889,133352,2683529,2634471,12686,9.522,12441,9.338,411917,134792,277125,5.116,15.636,315553,113302,202251,4.301,11.978,96364,3.658,23.956,7873,8146,48626
2001,18,103145,132865,2597278,2627327,12662,9.53,12661,9.529,339766,120452,219314,4.585,12.932,400126,133555,266571,5.083,15.229,-60360,-2.297,25.864,7697,7950,55310
2002,18,103324,133826,2530360,2572365,14325,10.747,13269,9.954,377376,153849,223527,5.981,14.67,459729,143434,316295,5.576,17.872,-82353,-3.201,29.341,7809,8195,71359
2003,18,103624,134328,2538699,2533950,12865,9.608,12003,8.964,366991,114051,252940,4.501,14.483,356728,125298,231430,4.945,14.078,10263,0.405,28.156,7387,7629,50013
2004,18,104681,135995,2580782,2559309,13245,9.808,11328,8.389,353133,113081,240052,4.418,13.798,308931,97262,211669,3.8,12.071,44202,1.727,24.142,7354,7612,49210
2005,18,104848,136542,2599040,2589405,13027,9.572,12142,8.921,337434,115009,222425,4.442,13.031,318940,100555,218385,3.883,12.317,18494,0.714,24.634,7820,8065,51496
2006,18,105878,138964,2652845,2626892,14925,10.85,12101,8.797,366588,128635,237953,4.897,13.955,314276,96193,218083,3.662,11.964,52312,1.991,23.928,7989,8162,48955
2007,18,105735,139794,2631911,2642990,14098,10.132,12790,9.192,364512,122012,242500,4.616,13.792,387582,110079,277503,4.165,14.665,-23070,-0.873,27.583,8151,8333,53997
2008,18,104234,138211,2597910,2614231,12195,8.784,13427,9.672,326672,98653,228019,3.774,12.496,360090,115756,244334,4.428,13.774,-33418,-1.278,24.992,8557,8783,57797
2009,18,101292,134968,2433562,2516459,10373,7.593,13673,10.008,257076,82760,174316,3.289,10.216,423303,110750,312553,4.401,16.821,-166227,-6.606,20.432,8671,8934,56180
2010,18,99563,133254,2394006,2413274,10204,7.618,11596,8.657,271215,86176,185039,3.571,11.238,309940,84310,225630,3.494,12.843,-38725,-1.605,22.477,7288,7478,43654
2011,18,98476,132597,2432317,2411933,10896,8.208,11204,8.44,290242,78677,211565,3.262,12.034,248551,70410,178141,2.919,10.305,41691,1.729,20.61,7055,7380,38043
2012,18,98557,132678,2505427,2468035,11171,8.434,10718,8.092,336153,96619,239534,3.915,13.62,261360,79663,181697,3.228,10.59,74793,3.03,21.18,6342,6567,38975
2013,18,97959,132131,2541696,2523264,10267,7.765,10456,7.908,300280,80612,219668,3.195,11.9,263752,77946,185806,3.089,10.453,36528,1.448,20.906,6492,6593,40037
2014,18,97382,132145,2599176,2569528,10527,7.977,10176,7.711,307505,85728,221777,3.336,11.967,248724,75726,172998,2.947,9.68,58781,2.288,19.36,6420,6540,39047
2015,18,97689,133617,2663884,2630450,11353,8.553,9599,7.231,325232,95059,230173,3.614,12.364,257416,68384,189032,2.6,9.786,67816,2.578,19.572,6006,6196,36197
2016,18,98257,135824,2725176,2694197,11395,8.466,8941,6.643,319677,98648,221029,3.661,11.865,257815,61881,195934,2.297,9.569,61862,2.296,19.139,6082,6266,36840
2017,18,98589,136283,2770107,2744185,10649,7.837,9848,7.247,347081,89384,257697,3.257,12.648,295503,86078,209425,3.137,10.768,51578,1.88,21.537,6093,6245,42555
2018,18,98936,136371,2809313,2790965,10343,7.595,9960,7.314,333884,88024,245860,3.154,11.963,297365,96727,200638,3.466,10.655,36519,1.308,21.309,6752,7141,53647
1978,19,55817,65232,864891,835728,8705,13.555,6684,10.408,166330,58698,107632,7.024,19.902,107367,43339,64028,5.186,12.847,58963,7.055,25.694,4684,4734,22794
1979,19,56358,65971,902406,883624,7790,11.911,6651,10.169,151005,53862,97143,6.096,17.089,113393,43587,69806,4.933,12.833,37612,4.257,25.665,4591,4643,22995
1980,19,55978,65796,899244,899999,7155,10.897,6885,10.486,131852,54008,77844,6.001,14.65,132730,39697,93033,4.411,14.748,-878,-0.098,29.3,5023,5066,24020
1981,19,56051,66239,870957,883488,6973,10.603,6023,9.159,123059,63090,59969,7.141,13.929,148969,49406,99563,5.592,16.861,-25910,-2.933,27.858,4299,4386,19381
1982,19,54150,64796,840048,855054,6798,10.436,7480,11.483,113659,48693,64966,5.695,13.293,143411,44467,98944,5.2,16.772,-29752,-3.48,26.585,5333,5419,23912
1983,19,54852,65368,843745,838936,6869,10.633,5335,8.258,151763,78685,73078,9.379,18.09,143879,43897,99982,5.232,17.15,7884,0.94,34.3,3729,3790,18806
1984,19,55932,66620,875414,857060,7741,11.811,5579,8.512,136488,47177,89311,5.505,15.925,100311,31743,68568,3.704,11.704,36177,4.221,23.408,4120,4192,18756
1985,19,54546,65168,849515,859299,6635,10.154,6988,10.694,125155,45760,79395,5.325,14.565,142994,72140,70854,8.395,16.641,-17839,-2.076,29.13,5140,5223,25620
1986,19,53417,64119,861241,852438,6417,10.009,6409,9.996,140991,60574,80417,7.106,16.54,123707,45529,78178,5.341,14.512,17284,2.028,29.024,4554,4637,23252
1987,19,52972,63785,879032,874888,7003,11.051,6173,9.741,148222,59652,88570,6.818,16.942,138457,49610,88847,5.67,15.826,9765,1.116,31.651,4137,4199,23633
1988,19,53866,65188,931118,905439,6875,10.671,5347,8.3,156938,52901,104037,5.843,17.333,106144,38756,67388,4.28,11.723,50794,5.61,23.446,3770,3849,23309
1989,19,54376,66015,991424,960100,6742,10.329,5251,8.045,165892,64293,101599,6.696,17.279,104598,37672,66926,3.924,10.894,61294,6.384,21.789,3781,3871,23648
1990,19,55131,67149,1007976,991772,6725,10.145,5007,7.553,144239,47127,97112,4.752,14.544,111377,31128,80249,3.139,11.23,32862,3.313,22.46,3689,3785,20910
1991,19,55208,68045,1015741,1009940,6769,10.067,5161,7.675,138240,45978,92262,4.553,13.688,126243,37246,88997,3.688,12.5,11997,1.188,25,3689,3768,22309
1992,19,55564,68630,1030196,1018636,6580,9.677,5318,7.821,154828,52248,102580,5.129,15.2,131100,39423,91677,3.87,12.87,23728,2.329,25.74,3579,3662,22918
1993,19,56242,69174,1050739,1039859,6284,9.134,5527,8.034,141188,45015,96173,4.329,13.578,120004,34565,85439,3.324,11.54,21184,2.037,23.081,3679,3754,18242
1994,19,57004,70262,1075404,1065150,6702,9.614,5599,8.032,145982,47092,98890,4.421,13.705,126072,46039,80033,4.322,11.836,19910,1.869,23.672,3947,4058,25368
1995,19,57759,71367,1116962,1096798,6924,9.791,5626,7.956,156108,48571,107537,4.428,14.233,116258,39573,76685,3.608,10.6,39850,3.633,21.2,3964,4075,23668
1996,19,57961,71849,1139031,1126155,6706,9.395,5763,8.074,153728,52789,100939,4.688,13.651,127978,40086,87892,3.56,11.364,25750,2.287,22.728,4065,4149,21786
1997,19,58030,72087,1156625,1149198,6931,9.646,6462,8.993,174743,63854,110889,5.556,15.206,159925,58023,101902,5.049,13.916,14818,1.289,27.832,4248,4361,27372
1998,19,58659,73074,1219252,1195545,6750,9.295,5834,8.034,174990,55394,119596,4.633,14.637,127682,40235,87447,3.365,10.68,47308,3.957,21.36,3870,3964,20833
1999,19,58501,73397,1243999,1231698,6464,8.837,5958,8.146,175557,58041,117516,4.712,14.253,150642,51488,99154,4.18,12.23,24915,2.023,24.461,4087,4203,23859
2000,19,58357,73343,1275993,1262240,6197,8.456,6079,8.295,170003,58409,111594,4.627,13.468,142199,50225,91974,3.979,11.266,27804,2.203,22.531,3947,4080,22789
2001,19,57583,72867,1252483,1259133,6039,8.269,6360,8.709,144494,48645,95849,3.863,11.476,158282,46642,111640,3.704,12.571,-13788,-1.095,22.951,4127,4268,24288
2002,19,57320,72805,1228487,1245377,6766,9.29,6813,9.355,160335,60851,99484,4.886,12.874,193986,62073,131913,4.984,15.576,-33651,-2.702,25.749,3998,4138,31167
2003,19,57601,73050,1226471,1226912,6725,9.234,6278,8.62,153940,52775,101165,4.301,12.547,154919,46346,108573,3.777,12.627,-979,-0.08,25.094,3647,3734,19685
2004,19,57890,73373,1240586,1232673,6390,8.738,5909,8.08,158114,45841,112273,3.719,12.827,141729,46701,95028,3.789,11.498,16385,1.329,22.995,3751,3833,20961
2005,19,58391,74087,1264746,1252551,6676,9.06,5882,7.982,156555,50902,105653,4.064,12.499,132433,38906,93527,3.106,10.573,24122,1.926,21.146,3924,4009,20357
2006,19,58281,75039,1295145,1279730,8136,10.936,6849,9.206,171131,62013,109118,4.846,13.372,139889,43816,96073,3.424,10.931,31242,2.441,21.862,4891,4988,23918
2007,19,58280,75301,1294875,1294555,6691,8.915,6196,8.255,159887,47393,112494,3.661,12.351,159630,45164,114466,3.489,12.331,257,0.02,24.662,3893,3957,21830
2008,19,57613,74686,1306428,1299626,5989,7.995,6443,8.601,160478,43544,116934,3.351,12.348,147049,43840,103209,3.373,11.315,13429,1.033,22.629,4117,4202,21932
2009,19,56816,73970,1275475,1290660,5341,7.182,6137,8.252,138683,43309,95374,3.356,10.745,168880,39313,129567,3.046,13.085,-30197,-2.34,21.49,4058,4119,23547
2010,19,56389,73718,1246928,1260907,5373,7.284,5465,7.409,121342,36127,85215,2.865,9.623,148369,39107,109262,3.101,11.767,-27027,-2.143,19.247,3383,3458,23400
2011,19,55947,73512,1255926,1250645,5505,7.487,5538,7.532,133633,37840,95793,3.026,10.685,122898,35117,87781,2.808,9.827,10735,0.858,19.654,3499,3572,18145
2012,19,56156,73739,1280841,1269061,5666,7.705,5258,7.15,147137,35707,111430,2.814,11.594,123561,38289,85272,3.017,9.736,23576,1.858,19.473,3192,3265,18406
2013,19,55621,73476,1296157,1288162,5322,7.238,5419,7.37,135336,38425,96911,2.983,10.506,119310,30648,88662,2.379,9.262,16026,1.244,18.524,3311,3357,16208
2014,19,55539,73556,1304768,1300192,5234,7.128,4986,6.79,124148,36631,87517,2.817,9.548,114920,33847,81073,2.603,8.839,9228,0.71,17.677,3208,3304,16868
2015,19,55778,74118,1335032,1319672,5652,7.661,4968,6.734,142946,41950,100996,3.179,10.832,111516,31569,79947,2.392,8.45,31430,2.382,16.901,3156,3230,15971
2016,19,56004,74980,1348466,1341225,5782,7.762,4805,6.45,137488,40377,97111,3.01,10.251,122748,30104,92644,2.245,9.152,14740,1.099,18.304,3226,3306,17528
2017,19,55899,74901,1353035,1349331,5588,7.465,5503,7.351,152008,39423,112585,2.922,11.265,145985,40566,105419,3.006,10.819,6023,0.446,21.638,3402,3464,18169
2018,19,56276,75324,1363022,1356808,5534,7.375,4958,6.607,137504,36675,100829,2.703,10.134,124783,31869,92914,2.349,9.197,12721,0.938,18.394,3523,3710,18640
1978,20,46012,53540,702527,681060,7545,14.321,5837,11.079,142925,52544,90381,7.715,20.986,100209,42042,58167,6.173,14.714,42716,6.272,29.427,3993,4040,20806
1979,20,47058,54721,748765,725524,7157,13.273,5562,10.315,141474,49053,92421,6.761,19.5,94089,37997,56092,5.237,12.968,47385,6.531,25.937,3742,3794,18616
1980,20,46966,54929,762655,757626,6440,11.79,5828,10.669,123784,47417,76367,6.259,16.338,113640,32176,81464,4.247,14.999,10144,1.339,29.999,4225,4273,20567
1981,20,47382,55632,763032,762237,6587,11.966,5414,9.835,115345,46041,69304,6.04,15.132,114389,34038,80351,4.466,15.007,956,0.125,30.014,3686,3749,17501
1982,20,46936,55390,754412,756878,6832,12.38,6425,11.642,116732,47272,69460,6.246,15.423,122180,37410,84770,4.943,16.143,-5448,-0.72,30.846,4557,4654,23840
1983,20,48076,56596,737718,743472,6984,12.574,4874,8.775,121158,51984,69174,6.992,16.296,132427,34403,98024,4.627,17.812,-11269,-1.516,32.592,3382,3448,18287
1984,20,49893,58607,783791,758535,8057,14.092,5191,9.079,146588,50060,96528,6.6,19.325,94853,33970,60883,4.478,12.505,51735,6.82,25.01,3789,3850,19706
1985,20,49784,58484,801703,787898,7139,12.319,6071,10.476,139547,53347,86200,6.771,17.711,111712,47355,64357,6.01,14.178,27835,3.533,28.357,4415,4500,26059
1986,20,49146,58074,818711,808217,6968,12.096,6033,10.473,136863,54052,82811,6.688,16.934,116619,38347,78272,4.745,14.429,20244,2.505,28.858,4389,4488,23228
1987,20,48844,57913,794166,792987,7089,12.325,6302,10.956,143158,65653,77505,8.279,18.053,141915,45531,96384,5.742,17.896,1243,0.157,35.793,4290,4385,23888
1988,20,50020,59770,823232,808621,7531,12.817,5509,9.376,144584,62059,82525,7.675,17.88,116096,39955,76141,4.941,14.357,28488,3.523,28.715,3913,4002,22930
1989,20,50156,60161,865459,839606,6994,11.737,5851,9.819,168193,77370,90823,9.215,20.032,115697,42894,72803,5.109,13.78,52496,6.252,27.56,4288,4382,24137
1990,20,50097,60279,893549,877743,6634,11.076,5870,9.8,140077,49217,90860,5.607,15.959,109217,36841,72376,4.197,12.443,30860,3.516,24.886,4343,4447,23296
1991,20,49685,60431,889059,889221,6979,11.638,6048,10.086,135379,54681,80698,6.149,15.224,135648,45214,90434,5.085,15.255,-269,-0.03,30.449,4259,4400,28123
1992,20,50005,61019,899322,891261,6718,11.137,5323,8.824,140822,52702,88120,5.913,15.8,125168,37081,88087,4.161,14.044,15654,1.756,28.088,3547,3612,22590
1993,20,50985,61911,911202,903636,6583,10.727,5494,8.953,132967,41491,91476,4.592,14.715,118063,38458,79605,4.256,13.065,14904,1.649,26.131,3610,3692,20819
1994,20,52092,63241,942210,927267,7077,11.316,5677,9.077,144639,50157,94482,5.409,15.598,115005,40381,74624,4.355,12.403,29634,3.196,24.805,3951,4108,23170
1995,20,52951,64449,974150,957904,7014,11.003,5605,8.793,141964,51083,90881,5.333,14.82,109256,36439,72817,3.804,11.406,32708,3.415,22.811,3977,4082,21668
1996,20,53267,65051,990678,977106,6960,10.79,5869,9.098,150374,54765,95609,5.605,15.39,123502,44128,79374,4.516,12.64,26872,2.75,25.279,4155,4264,25309
1997,20,53749,65840,1027758,1010377,7398,11.322,6403,9.799,172662,64031,108631,6.337,17.089,137890,48510,89380,4.801,13.647,34772,3.441,27.295,4197,4286,24837
1998,20,54426,66892,1076519,1060506,7078,10.655,6150,9.258,174373,61963,112410,5.843,16.442,141844,53910,87934,5.083,13.375,32529,3.067,26.75,4060,4189,24609
1999,20,54445,67239,1097438,1086279,6784,10.133,6209,9.274,173870,63382,110488,5.835,16.006,150570,60573,89997,5.576,13.861,23300,2.145,27.722,4104,4225,25055
2000,20,54499,67531,1115469,1106037,6789,10.091,6287,9.345,170208,64938,105270,5.871,15.389,152433,55228,97205,4.993,13.782,17775,1.607,27.564,4054,4152,23509
2001,20,54181,67467,1110272,1114932,6691,9.927,6567,9.743,147892,54223,93669,4.863,13.265,157505,50308,107197,4.512,14.127,-9613,-0.862,26.529,4221,4318,24369
2002,20,54014,67721,1098600,1107133,7367,10.897,7131,10.548,172308,72056,100252,6.508,15.563,190060,61412,128648,5.547,17.167,-17752,-1.603,31.127,4334,4483,32371
2003,20,54289,68029,1107415,1103696,6819,10.064,6269,9.253,159389,59076,100313,5.353,14.441,151998,49176,102822,4.456,13.772,7391,0.67,27.543,3893,3979,23324
2004,20,54874,68632,1112209,1109338,6768,9.919,5971,8.751,145427,50775,94652,4.577,13.109,140319,44256,96063,3.989,12.649,5108,0.46,25.298,3786,3871,21674
2005,20,55433,69415,1122362,1118041,6919,10.029,6064,8.79,151979,51484,100495,4.605,13.593,143143,47782,95361,4.274,12.803,8836,0.79,25.606,3976,4064,21987
2006,20,55574,70056,1157012,1141049,7911,11.368,6980,10.03,166061,58972,107089,5.168,14.553,133432,44644,88788,3.913,11.694,32629,2.86,23.388,4898,4997,24918
2007,20,55672,70548,1178251,1167964,7072,10.075,6360,9.061,171651,62476,109175,5.349,14.697,151321,47057,104264,4.029,12.956,20330,1.741,25.912,4035,4112,23459
2008,20,55062,69975,1188853,1182577,6084,8.671,6461,9.208,155937,43196,112741,3.653,13.186,143498,42443,101055,3.589,12.134,12439,1.052,24.269,4147,4250,23195
2009,20,54152,69119,1155249,1173053,5455,7.84,6381,9.17,125991,39855,86136,3.398,10.74,161840,39500,122340,3.367,13.796,-35849,-3.056,21.481,4167,4294,22227
2010,20,53421,68465,1122419,1139232,5348,7.782,5864,8.533,119262,38485,80777,3.378,10.469,152877,41898,110979,3.678,13.419,-33615,-2.951,20.937,3711,3790,20064
2011,20,52604,68072,1121418,1121653,5664,8.308,5878,8.621,131692,44988,86704,4.011,11.741,131996,37838,94158,3.373,11.768,-304,-0.027,23.482,3830,3899,19279
2012,20,52557,67981,1142112,1131264,5653,8.323,5524,8.134,144628,43250,101378,3.823,12.785,122619,37552,85067,3.319,10.839,22009,1.946,21.678,3273,3414,18220
2013,20,52193,67651,1152346,1145816,5382,7.947,5527,8.161,139803,38905,100898,3.395,12.201,127661,43030,84631,3.755,11.141,12142,1.06,22.283,3421,3454,19114
2014,20,52361,68097,1174880,1162809,5670,8.365,5043,7.44,144203,47521,96682,4.087,12.401,119927,33655,86272,2.894,10.314,24276,2.088,20.627,3242,3319,18047
2015,20,52369,68426,1187818,1180156,5701,8.362,5207,7.637,149811,48448,101363,4.105,12.694,135192,36247,98945,3.071,11.455,14619,1.239,22.911,3350,3462,18582
2016,20,52614,69284,1187656,1187170,6015,8.745,5017,7.294,130993,45168,85825,3.805,11.034,130191,43489,86702,3.663,10.967,802,0.068,21.933,3408,3543,23419
2017,20,52243,68931,1194734,1187855,5528,8.01,5694,8.25,149608,46141,103467,3.884,12.595,135776,44692,91084,3.762,11.43,13832,1.164,22.861,3706,3817,21911
2018,20,51951,68432,1201033,1197906,5035,7.347,5226,7.626,136459,39211,97248,3.273,11.391,130116,36052,94064,3.01,10.862,6343,0.53,21.724,3745,3879,21314
1978,21,51255,59848,904777,874035,8758,14.856,6970,11.823,184998,65715,119283,7.519,21.166,123782,51422,72360,5.883,14.162,61216,7.004,28.324,4757,4814,22023
1979,21,52678,61652,958590,933135,8433,13.921,6288,10.38,178118,66294,111824,7.104,19.088,127747,47078,80669,5.045,13.69,50371,5.398,27.38,4349,4380,21521
1980,21,52112,61621,943879,950223,7371,11.997,7009,11.408,140053,59276,80777,6.238,14.739,152872,42470,110402,4.469,16.088,-12819,-1.349,29.478,5164,5215,26418
1981,21,51999,61698,940501,944715,6961,11.327,6474,10.535,135387,54903,80484,5.812,14.331,143077,42868,100209,4.538,15.145,-7690,-0.814,28.662,4285,4334,21323
1982,21,51522,61551,937665,938542,7677,12.523,7179,11.711,149240,68444,80796,7.293,15.901,150656,44555,106101,4.747,16.052,-1416,-0.151,31.803,5143,5183,25260
1983,21,52050,61829,933411,929918,7640,12.499,6231,10.194,165192,85230,79962,9.165,17.764,159319,56542,102777,6.08,17.133,5873,0.632,34.265,4163,4213,23069
1984,21,54749,65033,983868,954629,9368,14.86,5384,8.54,172060,70432,101628,7.378,18.024,112971,35627,77344,3.732,11.834,59089,6.19,23.668,4088,4148,23094
1985,21,55261,65543,1023088,999840,8388,12.956,6791,10.489,172846,64740,108106,6.475,17.287,126140,48927,77213,4.893,12.616,46706,4.671,25.232,4985,5076,26949
1986,21,55959,66535,1050505,1033329,8685,13.255,6664,10.17,173108,65488,107620,6.338,16.752,138479,46715,91764,4.521,13.401,34629,3.351,26.802,4837,4888,25980
1987,21,56657,67626,1056749,1069869,8971,13.49,6725,10.112,187098,74027,113071,6.919,17.488,212322,56229,156093,5.256,19.846,-25224,-2.358,34.976,4734,4773,27349
1988,21,57939,69792,1100544,1076805,9250,13.481,6895,10.049,201591,81553,120038,7.574,18.721,153719,58202,95517,5.405,14.275,47872,4.446,28.551,4958,5026,29189
1989,21,59052,71356,1147770,1121163,9080,12.933,6788,9.668,199377,71568,127809,6.383,17.783,147012,56597,90415,5.048,13.112,52365,4.671,26.225,4964,5067,29608
1990,21,59919,72531,1192723,1169674,8722,12.177,6909,9.646,196580,75620,120960,6.465,16.806,150580,50231,100349,4.294,12.874,46000,3.933,25.747,5138,5225,30379
1991,21,59480,73176,1187842,1190085,8574,11.826,7224,9.964,184827,76830,107997,6.456,15.531,189491,62218,127273,5.228,15.922,-4664,-0.392,31.061,5361,5456,36588
1992,21,59649,73603,1212511,1199939,8124,11.132,6882,9.43,185397,66862,118535,5.572,15.451,159628,48560,111068,4.047,13.303,25769,2.148,26.606,4785,4864,27732
1993,21,60817,74776,1247991,1229205,8358,11.285,6938,9.367,196688,68683,128005,5.588,16.001,159675,56165,103510,4.569,12.99,37013,3.011,25.98,4676,4793,26572
1994,21,61895,76251,1285959,1268804,8307,11.003,6794,8.999,197025,68307,128718,5.384,15.528,162225,55388,106837,4.365,12.786,34800,2.743,25.571,4777,4881,32164
1995,21,63186,78036,1342144,1313399,8760,11.371,6760,8.775,213696,74337,139359,5.66,16.27,155321,55257,100064,4.207,11.826,58375,4.445,23.652,4750,4853,29383
1996,21,63546,78985,1348265,1340892,8665,11.073,7195,9.195,199419,77693,121726,5.794,14.872,184610,59768,124842,4.457,13.768,14809,1.104,27.535,5078,5200,32840
1997,21,64149,79991,1398663,1374058,9066,11.424,7799,9.828,239059,83090,155969,6.047,17.398,189397,68520,120877,4.987,13.784,49662,3.614,27.568,5167,5322,35563
1998,21,64956,81370,1446973,1429476,8812,10.925,7394,9.167,235677,92697,142980,6.485,16.487,199729,66498,133231,4.652,13.972,35948,2.515,27.944,4874,4976,29175
1999,21,65145,82069,1471325,1458143,8502,10.425,7478,9.169,227865,81719,146146,5.604,15.627,201672,65481,136191,4.491,13.831,26193,1.796,27.661,5024,5186,33302
2000,21,64873,82113,1504521,1482943,8123,9.912,7793,9.51,233119,80340,152779,5.418,15.72,189654,69944,119710,4.717,12.789,43465,2.931,25.578,4974,5111,32998
2001,21,64692,82081,1488207,1496343,8019,9.784,7783,9.496,202046,68719,133327,4.592,13.503,219047,70569,148478,4.716,14.639,-17001,-1.136,27.005,4890,5064,32477
2002,21,64519,82697,1458448,1475119,8809,10.699,8078,9.812,216634,81651,134983,5.535,14.686,249555,74616,174939,5.058,16.918,-32921,-2.232,29.372,4997,5141,35772
2003,21,64541,82934,1460894,1459123,7928,9.587,7449,9.008,205863,67794,138069,4.646,14.109,203473,64026,139447,4.388,13.945,2390,0.164,27.89,4751,4892,29815
2004,21,65075,83612,1481274,1472445,8036,9.663,7141,8.587,204377,66377,138000,4.508,13.88,186449,65695,120754,4.462,12.663,17928,1.218,25.325,4556,4706,33478
2005,21,65590,84514,1506255,1495457,8400,10.003,7330,8.728,211894,67729,144165,4.529,14.169,189907,54387,135520,3.637,12.699,21987,1.47,25.398,4880,4987,28527
2006,21,65964,85747,1544724,1524999,9327,10.978,7757,9.13,223657,80121,143536,5.254,14.666,184687,60402,124285,3.961,12.111,38970,2.555,24.221,5487,5578,32008
2007,21,65873,86234,1540972,1543028,8628,10.054,7799,9.088,218807,76280,142527,4.944,14.18,223039,62278,160761,4.036,14.455,-4232,-0.274,28.361,4987,5066,31847
2008,21,64823,85491,1535807,1536322,7458,8.7,7925,9.245,201192,61882,139310,4.028,13.096,202740,63018,139722,4.102,13.196,-1548,-0.101,26.191,5199,5302,31814
2009,21,63441,84188,1465692,1503483,6762,7.965,8177,9.632,165449,60131,105318,3.999,11.004,240563,62288,178275,4.143,16,-75114,-4.996,22.009,5237,5392,32942
2010,21,62503,83472,1438066,1451851,6684,7.983,7191,8.589,164333,55325,109008,3.811,11.319,191208,49203,142005,3.389,13.17,-26875,-1.851,22.638,4606,4751,27530
2011,21,61684,82956,1445259,1441506,6703,8.067,6976,8.395,172364,50043,122321,3.472,11.957,163726,49785,113941,3.454,11.358,8638,0.599,22.716,4641,4796,27913
2012,21,61609,83035,1477637,1461244,6961,8.401,6616,7.984,196075,57155,138920,3.911,13.418,163136,49108,114028,3.361,11.164,32939,2.254,22.328,4034,4177,22143
2013,21,61728,83398,1500192,1489220,7315,8.804,6695,8.058,192556,62806,129750,4.217,12.93,170470,51951,118519,3.488,11.447,22086,1.483,22.894,4168,4234,24440
2014,21,62261,84518,1530562,1515341,7755,9.248,6425,7.662,198031,66394,131637,4.381,13.068,166069,45377,120692,2.995,10.959,31962,2.109,21.918,4133,4232,23256
2015,21,62234,85143,1577973,1554741,7242,8.55,6366,7.515,196429,56784,139645,3.652,12.634,150031,43381,106650,2.79,9.65,46398,2.984,19.3,4134,4203,22482
2016,21,62274,85697,1607193,1592375,6974,8.173,6239,7.312,190255,57297,132958,3.598,11.948,160661,46358,114303,2.911,10.089,29594,1.858,20.179,4248,4436,24163
2017,21,61828,85198,1623232,1611639,6801,7.97,7078,8.294,206262,60556,145706,3.757,12.798,184223,62398,121825,3.872,11.431,22039,1.367,22.862,4698,4761,31071
2018,21,60775,84019,1642716,1632447,6078,7.229,6190,7.362,188810,56282,132528,3.448,11.566,167728,50071,117657,3.067,10.275,21082,1.291,20.549,4337,4504,29416
1978,22,61342,72593,1152537,1083373,11377,16.009,8327,11.717,293117,104999,188118,9.692,27.056,154539,61171,93368,5.646,14.265,138578,12.791,28.529,5708,5772,28271
1979,22,63766,75572,1232032,1192552,11452,15.552,7585,10.3,262029,93369,168660,7.829,21.972,182878,68459,114419,5.741,15.335,79151,6.637,30.67,5309,5366,34629
1980,22,64204,76550,1246242,1238380,10431,13.792,8593,11.362,227788,80948,146840,6.537,18.394,211149,63892,147257,5.159,17.05,16639,1.344,34.101,6256,6332,36440
1981,22,66188,79141,1309423,1275262,11096,14.329,7691,9.932,253329,87490,165839,6.861,19.865,184384,57388,126996,4.5,14.459,68945,5.406,28.917,5151,5239,27875
1982,22,67895,81470,1330965,1318061,11906,14.894,8838,11.056,265540,107144,158396,8.129,20.146,239988,76426,163562,5.798,18.208,25552,1.939,36.415,6338,6416,38461
1983,22,69705,83179,1234865,1274663,11233,13.772,8008,9.818,215608,82161,133447,6.446,16.915,294560,71293,223267,5.593,23.109,-78952,-6.194,33.83,5697,5780,37478
1984,22,71684,85619,1269008,1247031,12558,15.004,8710,10.407,241517,94337,147180,7.565,19.367,198029,63664,134365,5.105,15.88,43488,3.487,31.76,6404,6518,34242
1985,22,71297,85229,1267580,1259423,11522,13.619,10264,12.132,238667,95273,143394,7.565,18.951,222592,80498,142094,6.392,17.674,16075,1.276,35.348,7591,7736,50763
1986,22,69695,84050,1243352,1249513,10948,13.072,10349,12.357,225395,95328,130067,7.629,18.039,237544,72380,165164,5.793,19.011,-12149,-0.972,36.077,7788,7902,43865
1987,22,66402,80524,1175254,1207653,10102,12.418,11756,14.451,211090,95124,115966,7.877,17.479,275186,103709,171477,8.588,22.787,-64096,-5.307,34.959,8117,8256,53178
1988,22,66121,81213,1189715,1178352,10561,13.084,9572,11.858,222499,87436,135063,7.42,18.882,200331,72220,128111,6.129,17.001,22168,1.881,34.002,6717,6875,42008
1989,22,65327,80426,1219884,1199435,9417,11.749,8869,11.065,225405,81116,144289,6.763,18.793,185162,70926,114236,5.913,15.437,40243,3.355,30.875,6267,6452,43516
1990,22,65770,81153,1276624,1244486,9655,12.028,7889,9.828,234580,81032,153548,6.511,18.85,170212,60540,109672,4.865,13.677,64368,5.172,27.355,5680,5825,37659
1991,22,65778,82185,1299989,1284579,9968,12.282,7913,9.75,231275,90276,140999,7.028,18.004,200850,70254,130596,5.469,15.635,30425,2.368,31.271,5621,5781,43691
1992,22,66349,82779,1310039,1298293,9375,11.447,7616,9.299,230978,78409,152569,6.039,17.791,206999,67103,139896,5.169,15.944,23979,1.847,31.888,5003,5124,37096
1993,22,67983,84289,1327646,1317733,9371,11.233,7644,9.163,223836,73524,150312,5.58,16.986,204402,68203,136199,5.176,15.512,19434,1.475,31.023,5172,5271,38717
1994,22,69520,86334,1385199,1357169,10135,11.885,8019,9.404,244810,93630,151180,6.899,18.038,188029,62255,125774,4.587,13.855,56781,4.184,27.709,5551,5776,40083
1995,22,70777,87916,1413602,1395710,9843,11.313,8018,9.216,243014,92199,150815,6.606,17.411,206469,79580,126889,5.702,14.793,36545,2.618,29.586,5544,5771,40588
1996,22,71807,89344,1442688,1422590,9807,11.098,7849,8.882,237282,81013,156269,5.695,16.68,196842,63519,133323,4.465,13.837,40440,2.843,27.674,5528,5655,36367
1997,22,72603,90435,1479143,1462287,10340,11.518,9012,10.039,266826,91302,175524,6.244,18.247,233115,84495,148620,5.778,15.942,33711,2.305,31.884,5984,6155,41317
1998,22,73463,91572,1566166,1540752,9810,10.778,8705,9.564,274359,94270,180089,6.118,17.807,222037,76838,145199,4.987,14.411,52322,3.396,28.822,5679,5871,41748
1999,22,73264,91848,1573990,1571730,9378,10.243,8792,9.603,243733,81172,162561,5.165,15.507,239069,85835,153234,5.461,15.211,4664,0.297,30.421,5852,6073,48788
2000,22,72808,91771,1590945,1582667,9438,10.296,9237,10.076,263263,103201,160062,6.521,16.634,246104,92395,153709,5.838,15.55,17159,1.084,31.1,5804,6022,49734
2001,22,72647,91776,1590402,1590928,9372,10.231,9025,9.852,239219,81874,157345,5.146,15.036,240900,77611,163289,4.878,15.142,-1681,-0.106,30.073,5486,5670,39712
2002,22,73105,92781,1573686,1585941,10167,11.022,9088,9.852,258809,103570,155239,6.531,16.319,284646,97175,187471,6.127,17.948,-25837,-1.629,32.638,5554,5797,49777
2003,22,73731,93338,1597065,1584733,9241,9.947,8374,9.014,251724,82804,168920,5.225,15.884,226938,72597,154341,4.581,14.32,24786,1.564,28.641,5279,5387,37227
2004,22,74453,94198,1613154,1604877,9094,9.711,7986,8.528,236025,69200,166825,4.312,14.707,219782,64900,154882,4.044,13.695,16243,1.012,27.389,5174,5298,34601
2005,22,74685,94705,1606675,1611222,9322,9.88,8608,9.124,240625,74977,165648,4.653,14.934,248676,89490,159186,5.554,15.434,-8051,-0.5,29.869,5602,5774,42464
2006,22,72038,92445,1586062,1595008,10847,11.618,12686,13.588,277790,101559,176231,6.367,17.416,297560,100836,196724,6.322,18.656,-19770,-1.239,34.832,7757,7917,47644
2007,22,74811,95877,1635339,1610304,11778,12.534,7959,8.47,284034,92137,191897,5.722,17.639,233289,66790,166499,4.148,14.487,50745,3.151,28.975,4894,4975,31335
2008,22,74836,96243,1635918,1633522,9251,9.646,8574,8.94,236820,71686,165134,4.388,14.498,232118,66200,165918,4.053,14.21,4702,0.288,28.419,5540,5631,31956
2009,22,74554,96173,1628774,1636373,8436,8.763,8634,8.968,212453,70575,141878,4.313,12.983,226665,65189,161476,3.984,13.852,-14212,-0.869,25.966,5649,5744,37118
2010,22,74065,96065,1592331,1610727,8142,8.482,7993,8.327,186058,67094,118964,4.165,11.551,223720,54564,169156,3.388,13.889,-37662,-2.338,23.102,5148,5293,32583
2011,22,73731,96338,1609455,1600259,8439,8.785,7884,8.207,208602,67663,140939,4.228,13.036,190067,49423,140644,3.088,11.877,18535,1.158,23.755,5145,5300,26581
2012,22,74017,96788,1633523,1619286,8536,8.854,7772,8.062,222062,64519,157543,3.984,13.714,194389,55422,138967,3.423,12.005,27673,1.709,24.009,4683,4850,28799
2013,22,74035,96843,1671073,1651367,8077,8.357,7701,7.968,239843,72398,167445,4.384,14.524,199378,73279,126099,4.437,12.074,40465,2.45,24.147,4799,4875,36239
2014,22,74116,97502,1704308,1689244,8211,8.46,7311,7.533,212863,68057,144806,4.029,12.601,182299,54471,127828,3.225,10.792,30564,1.809,21.584,4757,4853,27902
2015,22,73996,98008,1716979,1709760,8372,8.576,7603,7.788,225773,74740,151033,4.371,13.205,213504,54551,158953,3.191,12.487,12269,0.718,24.975,4933,5031,29126
2016,22,73953,98793,1701205,1708276,8545,8.695,7513,7.645,199435,71968,127467,4.213,11.675,214254,54466,159788,3.188,12.542,-14819,-0.867,23.349,5201,5324,32490
2017,22,73679,98273,1682442,1689904,7802,7.928,8078,8.208,209914,59209,150705,3.504,12.422,224697,64071,160626,3.791,13.296,-14783,-0.875,24.843,5110,5224,30774
2018,22,73624,97892,1690342,1687462,7654,7.815,7760,7.923,199247,55536,143711,3.291,11.807,193754,56386,137368,3.341,11.482,5493,0.326,22.964,5515,5828,34516
1978,23,19754,22525,308234,297382,3348,15.195,2365,10.734,58538,20682,37856,6.955,19.684,36644,15041,21603,5.058,12.322,21894,7.362,24.644,1651,1672,7049
1979,23,20268,23166,316031,307943,3051,13.411,2219,9.754,53915,19778,34137,6.423,17.508,38156,12968,25188,4.211,12.391,15759,5.118,24.781,1571,1580,6387
1980,23,19985,22921,319042,321010,2637,11.487,2706,11.788,48150,17413,30737,5.424,15,51474,15969,35505,4.975,16.035,-3324,-1.035,29.999,1819,1841,8639
1981,23,19936,22938,316535,317642,2546,11.15,2340,10.247,45129,15275,29854,4.809,14.208,47146,16615,30531,5.231,14.843,-2017,-0.635,28.415,1585,1600,5748
1982,23,19722,22875,321233,318706,2737,12.005,2584,11.334,52915,21042,31873,6.602,16.603,47627,16570,31057,5.199,14.944,5288,1.659,29.888,1797,1819,8083
1983,23,20136,23327,326194,322507,2891,12.624,2037,8.895,52329,17869,34460,5.541,16.226,44803,14648,30155,4.542,13.892,7526,2.334,27.784,1352,1372,6830
1984,23,21542,24843,346239,334396,3597,15.017,1816,7.582,57090,18856,38234,5.639,17.073,33375,10877,22498,3.253,9.981,23715,7.092,19.961,1280,1307,5954
1985,23,22344,25636,352097,348244,3561,14.199,2447,9.757,60676,23473,37203,6.74,17.423,53045,22016,31029,6.322,15.232,7631,2.191,30.464,1673,1701,8938
1986,23,23292,26687,365322,356710,3980,15.33,2529,9.741,64687,24078,40609,6.75,18.134,47250,17593,29657,4.932,13.246,17437,4.888,26.492,1766,1812,10266
1987,23,24603,28264,390626,387626,4519,16.522,2694,9.85,75656,31758,43898,8.193,19.518,72327,18439,53888,4.757,18.659,3329,0.859,37.318,1933,1958,10295
1988,23,25980,29908,415930,404075,4571,15.739,2839,9.775,76508,25677,50831,6.355,18.934,52919,17664,35255,4.371,13.096,23589,5.838,26.193,2056,2070,10533
1989,23,26850,30977,434688,426975,4470,14.761,3082,10.177,78654,29273,49381,6.856,18.421,63280,21443,41837,5.022,14.821,15374,3.601,29.641,2329,2384,13260
1990,23,26386,30608,422442,426882,3498,11.416,3564,11.631,61287,25063,36224,5.871,14.357,70303,20732,49571,4.857,16.469,-9016,-2.112,28.714,2748,2792,14724
1991,23,25576,30113,401201,411199,3362,11.133,3532,11.696,52637,21902,30735,5.326,12.801,72493,23361,49132,5.681,17.63,-19856,-4.829,25.602,2558,2588,14454
1992,23,25346,29886,394617,395345,3209,10.761,3079,10.325,56441,20726,35715,5.243,14.276,58120,18839,39281,4.765,14.701,-1679,-0.425,28.553,2040,2080,10262
1993,23,25660,30069,407189,400737,3324,11.106,3048,10.183,63437,21718,41719,5.42,15.83,50773,17442,33331,4.352,12.67,12664,3.16,25.34,1968,2022,9494
1994,23,26117,30680,417750,412838,3551,11.699,2897,9.544,61326,21450,39876,5.196,14.855,51982,18874,33108,4.572,12.591,9344,2.263,25.183,2065,2106,12069
1995,23,26753,31356,432145,424716,3651,11.789,2877,9.29,61643,20112,41531,4.735,14.514,46361,15066,31295,3.547,10.916,15282,3.598,21.832,2006,2047,9770
1996,23,27157,31827,434198,431658,3699,11.747,3023,9.6,60023,22691,37332,5.257,13.905,54921,18843,36078,4.365,12.723,5102,1.182,25.447,2111,2133,11219
1997,23,27585,32428,444096,438099,3822,11.912,3134,9.768,68711,24773,43938,5.655,15.684,57064,21524,35540,4.913,13.025,11647,2.659,26.051,2097,2143,11537
1998,23,28251,33215,460517,454636,3782,11.526,2978,9.076,67412,22960,44452,5.05,14.828,55035,18868,36167,4.15,12.105,12377,2.722,24.211,1989,2020,9849
1999,23,28818,33874,472436,466339,3694,11.028,2942,8.783,68992,22956,46036,4.923,14.794,56782,18592,38190,3.987,12.176,12210,2.618,24.352,1992,2043,11252
2000,23,29183,34415,490251,481677,3597,10.551,2950,8.653,72177,23507,48670,4.88,14.985,55053,20813,34240,4.321,11.429,17124,3.555,22.859,1996,2043,10610
2001,23,29292,34734,496982,493246,3620,10.499,3113,9.028,70403,28018,42385,5.68,14.273,63484,21342,42142,4.327,12.871,6919,1.403,25.741,2107,2139,11062
2002,23,29176,34949,487236,494778,3877,11.137,3604,10.353,70153,28981,41172,5.857,14.179,85129,29635,55494,5.99,17.206,-14976,-3.027,28.357,2244,2280,17290
2003,23,29479,35321,487916,486805,3648,10.411,3083,8.799,67166,23358,43808,4.798,13.797,65207,21659,43548,4.449,13.395,1959,0.402,26.79,1933,1981,11025
2004,23,29940,35840,494469,490860,3662,10.311,3013,8.484,60877,18983,41894,3.867,12.402,53633,18068,35565,3.681,10.926,7244,1.476,21.853,2039,2076,11053
2005,23,30292,36376,497416,495714,3754,10.416,3086,8.562,62416,21727,40689,4.383,12.591,59025,17151,41874,3.46,11.907,3391,0.684,23.814,2045,2063,9646
2006,23,30657,37079,505914,501784,4282,11.683,3425,9.345,65923,25707,40216,5.123,13.138,57746,18556,39190,3.698,11.508,8177,1.63,23.016,2463,2488,10848
2007,23,30709,37362,500434,502823,3929,10.583,3453,9.301,66650,23547,43103,4.683,13.255,71555,26137,45418,5.198,14.231,-4905,-0.975,26.51,2294,2310,13173
2008,23,30098,36790,506171,503170,3413,9.228,3804,10.285,65668,20534,45134,4.081,13.051,59976,19607,40369,3.897,11.92,5692,1.131,23.839,2495,2543,11451
2009,23,28973,35697,487849,497706,2876,7.941,3920,10.823,51101,17680,33421,3.552,10.267,70858,19921,50937,4.003,14.237,-19757,-3.97,20.535,2447,2470,11670
2010,23,28759,35545,479900,483972,3153,8.865,3194,8.981,50326,17880,32446,3.694,10.399,58570,16337,42233,3.376,12.102,-8244,-1.703,20.797,1935,1970,8468
2011,23,28335,35175,478327,478807,3107,8.805,3332,9.442,52918,16986,35932,3.548,11.052,53930,17569,36361,3.669,11.263,-1012,-0.211,22.104,1969,2062,10152
2012,23,28232,35094,483996,480900,3168,9.035,3107,8.861,56480,16814,39666,3.496,11.745,50577,15489,35088,3.221,10.517,5903,1.227,21.034,1840,1915,8726
2013,23,28117,35026,483577,484245,3039,8.686,2964,8.471,54096,15832,38264,3.269,11.171,55275,19464,35811,4.019,11.415,-1179,-0.243,22.342,1706,1739,9396
2014,23,28205,35270,490362,486915,3121,8.895,2757,7.857,55583,20298,35285,4.169,11.415,48690,14225,34465,2.921,10,6893,1.416,19.999,1681,1709,6911
2015,23,28401,35606,499632,494727,3169,8.957,2720,7.688,57793,17541,40252,3.546,11.682,47766,15524,32242,3.138,9.655,10027,2.027,19.31,1721,1752,7510
2016,23,29083,36442,510272,505043,3435,9.549,2492,6.928,56985,19280,37705,3.817,11.283,46544,15009,31535,2.972,9.216,10441,2.067,18.432,1682,1721,8674
2017,23,29109,36428,512689,510725,3014,8.287,2896,7.963,58344,15268,43076,2.989,11.424,54690,17676,37014,3.461,10.708,3654,0.715,21.417,1894,1935,9184
2018,23,29262,36429,516469,514469,2791,7.673,2679,7.365,55268,14025,41243,2.726,10.743,51143,14391,36752,2.797,9.941,4125,0.802,19.882,1927,1983,9626
1978,24,60009,71403,1194719,1158306,9685,13.772,7531,10.709,233580,77146,156434,6.66,20.166,160780,63838,96942,5.511,13.881,72800,6.285,27.761,4862,4958,27639
1979,24,61980,73947,1247392,1213827,9675,13.359,6625,9.148,225748,72131,153617,5.942,18.598,158632,59545,99087,4.906,13.069,67116,5.529,26.138,4402,4467,23659
1980,24,62574,74910,1276870,1263456,9036,12.201,7341,9.912,214665,75323,139342,5.962,16.99,187620,53380,134240,4.225,14.85,27045,2.141,29.7,4953,5052,27520
1981,24,63077,75991,1291630,1283993,8645,11.506,6929,9.222,201184,74238,126946,5.782,15.669,186133,49387,136746,3.846,14.496,15051,1.172,28.993,4394,4501,21926
1982,24,63141,76613,1304635,1296756,9456,12.451,8123,10.696,227002,97961,129041,7.554,17.505,210584,61388,149196,4.734,16.239,16418,1.266,32.479,5340,5449,29567
1983,24,65969,79637,1321115,1301928,10355,13.346,6259,8.067,224644,75452,149192,5.795,17.255,186534,52635,133899,4.043,14.328,38110,2.927,28.655,4141,4227,24227
1984,24,68422,82599,1422077,1367734,11165,13.853,7159,8.883,269905,94397,175508,6.902,19.734,160486,51758,108728,3.784,11.734,109419,8,23.467,4969,5054,26919
1985,24,70991,85559,1526942,1467932,12704,15.182,8938,10.682,316088,124976,191112,8.514,21.533,197728,77374,120354,5.271,13.47,118360,8.063,26.94,6418,6566,46658
1986,24,73944,89080,1594945,1553757,12766,14.741,7805,9.013,309420,114826,194594,7.39,19.914,228265,71952,156313,4.631,14.691,81155,5.223,29.382,5335,5436,36173
1987,24,76598,92829,1673352,1628501,13530,14.96,8760,9.686,338963,136503,202460,8.382,20.814,248676,84746,163930,5.204,15.27,90287,5.544,30.54,5942,6045,42489
1988,24,80084,97861,1751406,1715339,14296,15.013,9024,9.477,334986,136401,198585,7.952,19.529,262727,82413,180314,4.804,15.316,72259,4.213,30.633,6292,6423,44375
1989,24,82591,101259,1798761,1769552,13844,13.986,9295,9.39,322870,123434,199436,6.975,18.246,264314,88201,176113,4.984,14.937,58556,3.309,29.874,6441,6570,44808
1990,24,84731,104043,1845291,1817815,13348,13.076,9426,9.234,315924,111740,204184,6.147,17.379,261583,80590,180993,4.433,14.39,54341,2.989,28.78,6736,6895,49144
1991,24,83733,104254,1747476,1788478,12703,12.277,11132,10.759,254786,107979,146807,6.037,14.246,336617,103999,232618,5.815,18.821,-81831,-4.575,28.492,7809,7946,57849
1992,24,83957,104618,1725313,1730658,12054,11.61,10462,10.077,275311,101418,173893,5.86,15.908,285923,85323,200600,4.93,16.521,-10612,-0.613,31.816,6714,6890,42402
1993,24,85617,105432,1734315,1728687,12262,11.692,11149,10.631,280618,102030,178588,5.902,16.233,269405,88715,180690,5.132,15.584,11213,0.649,31.169,6717,6929,43632
1994,24,87079,107196,1753834,1746573,12324,11.596,10482,9.863,280872,96726,184146,5.538,16.081,266350,95921,170429,5.492,15.25,14522,0.831,30.5,6984,7184,48898
1995,24,89169,109691,1819830,1783818,13125,12.12,10335,9.543,300121,104081,196040,5.835,16.825,227730,82867,144863,4.645,12.766,72391,4.058,25.533,7015,7227,45457
1996,24,89527,110285,1808388,1804839,12272,11.196,10923,9.965,276366,103277,173089,5.722,15.313,271329,90779,180550,5.03,15.033,5037,0.279,30.067,7319,7495,47844
1997,24,90275,111332,1885366,1850111,13541,12.235,12226,11.047,357577,135481,222096,7.323,19.327,287228,109099,178129,5.897,15.525,70349,3.802,31.05,7830,8076,50170
1998,24,91176,112370,1946102,1921868,12539,11.208,11540,10.315,327481,120458,207023,6.268,17.04,278337,103280,175057,5.374,14.483,49144,2.557,28.965,7105,7377,47642
1999,24,91750,113172,1977715,1959877,12225,10.857,11083,9.843,328999,116570,212429,5.948,16.787,291829,106339,185490,5.426,14.89,37170,1.897,29.78,6972,7119,50988
2000,24,92041,113914,2065010,2028505,12063,10.635,11082,9.77,351484,114494,236990,5.644,17.327,279550,103686,175864,5.111,13.781,71934,3.546,27.562,6909,7081,41588
2001,24,92803,115062,2081301,2073269,12759,11.162,11247,9.839,325858,121782,204076,5.874,15.717,309957,105002,204955,5.065,14.95,15901,0.767,29.9,6707,7080,49209
2002,24,93760,116933,2060247,2077546,14086,12.147,12143,10.472,333940,134973,198967,6.497,16.074,368981,130170,238811,6.266,17.76,-35041,-1.687,32.148,7044,7290,65063
2003,24,95389,118498,2076646,2067689,12879,10.95,11118,9.453,310328,102052,208276,4.936,15.008,293096,87582,205514,4.236,14.175,17232,0.833,28.35,6580,6755,37806
2004,24,97377,120714,2141159,2110045,13235,11.073,10850,9.078,326401,105264,221137,4.989,15.469,263629,94507,169122,4.479,12.494,62772,2.975,24.988,6708,6833,40409
2005,24,99419,123158,2161948,2168711,14076,11.551,11485,9.425,306225,110640,195585,5.102,14.12,322516,94282,228234,4.347,14.871,-16291,-0.751,28.24,7110,7228,47458
2006,24,101592,126482,2232922,2197899,15847,12.708,12282,9.849,350332,130805,219527,5.951,15.939,280832,98755,182077,4.493,12.777,69500,3.162,25.555,8338,8473,48704
2007,24,101869,127365,2232668,2232594,14006,11.05,12780,10.083,327944,107431,220513,4.812,14.689,328606,100398,228208,4.497,14.719,-662,-0.03,29.378,7986,8106,45461
2008,24,100141,125758,2222940,2225864,12091,9.563,13458,10.644,305105,93139,211966,4.184,13.707,310226,103621,206605,4.655,13.937,-5121,-0.23,27.415,8559,8711,43265
2009,24,97137,123095,2122124,2175819,11122,8.929,14042,11.274,251714,93780,157934,4.31,11.569,358044,116046,241998,5.333,16.456,-106330,-4.887,23.137,8587,8727,47550
2010,24,95778,121612,2072353,2096282,11194,9.159,12412,10.155,244196,80744,163452,3.852,11.649,291787,83237,208550,3.971,13.919,-47591,-2.27,23.298,7327,7608,42103
2011,24,94966,121339,2107211,2090663,11480,9.46,11515,9.489,273369,85784,187585,4.103,13.076,240186,74701,165485,3.573,11.489,33183,1.587,22.977,7196,7312,36518
2012,24,95805,122127,2144349,2126113,11456,9.423,10353,8.516,282217,81471,200746,3.832,13.274,245383,74563,170820,3.507,11.541,36834,1.732,23.083,5964,6119,32611
2013,24,95959,122722,2175804,2159562,11507,9.41,10622,8.687,281667,91542,190125,4.239,13.043,249664,81506,168158,3.774,11.561,32003,1.482,23.122,6257,6414,44000
2014,24,96171,123811,2203927,2188942,11698,9.498,10413,8.454,260211,79015,181196,3.61,11.888,230871,64070,166801,2.927,10.547,29340,1.34,21.094,6460,6531,32474
2015,24,96337,124310,2231137,2217155,11252,9.079,10503,8.475,268576,90809,177767,4.096,12.114,239775,73187,166588,3.301,10.815,28801,1.299,21.629,6502,6622,35247
2016,24,97434,126348,2277511,2254669,11796,9.42,9550,7.626,270321,83136,187185,3.687,11.989,225038,70084,154954,3.108,9.981,45283,2.008,19.962,6316,6444,34982
2017,24,97533,126353,2328817,2301437,11043,8.747,10837,8.584,312067,85961,226106,3.735,13.56,258759,81042,177717,3.521,11.243,53308,2.316,22.487,6845,6967,39339
2018,24,97792,126435,2360944,2344212,10662,8.442,10373,8.214,281180,80243,200937,3.423,11.995,247222,73988,173234,3.156,10.546,33958,1.449,21.092,7275,7464,41680
1978,25,95939,110930,2048687,1972558,13323,12.143,10891,9.927,395619,121652,273967,6.167,20.056,242316,105429,136887,5.345,12.284,153303,7.772,24.569,6989,7111,39564
1979,25,97515,112995,2188522,2119358,12864,11.529,10039,8.997,385985,120881,265104,5.704,18.212,249722,89639,160083,4.23,11.783,136263,6.429,23.566,6233,6324,36887
1980,25,97713,113780,2244635,2217330,12021,10.637,10475,9.269,344034,109349,234685,4.932,15.516,289456,89090,200366,4.018,13.054,54578,2.461,26.109,6958,7099,40028
1981,25,99266,115977,2287707,2265380,12081,10.553,9080,7.932,355087,118677,236410,5.239,15.675,308532,94584,213948,4.175,13.619,46555,2.055,27.239,5408,5548,43392
1982,25,100178,117575,2314692,2305606,13164,11.314,10720,9.213,342385,132729,209656,5.757,14.85,323387,87824,235563,3.809,14.026,18998,0.824,28.052,7220,7337,44573
1983,25,102851,120552,2337500,2317616,13653,11.535,9262,7.826,364004,136503,227501,5.89,15.706,324913,86864,238049,3.748,14.019,39091,1.687,28.039,6206,6314,42015
1984,25,107703,125869,2507902,2414167,15450,12.609,8783,7.168,448617,151815,296802,6.289,18.583,259900,73079,186821,3.027,10.766,188717,7.817,21.531,6139,6230,38304
1985,25,110961,129637,2614214,2551069,16341,12.863,11151,8.777,458797,132770,326027,5.204,17.985,331509,111989,219520,4.39,12.995,127288,4.99,25.99,8014,8188,63782
1986,25,113874,133163,2663850,2627081,17225,13.203,11818,9.059,449914,158725,291189,6.042,17.126,376091,109102,266989,4.153,14.316,73823,2.81,28.632,8292,8459,62076
1987,25,117384,137660,2743083,2710671,18927,14.054,12962,9.624,481953,187081,294872,6.902,17.78,421187,128093,293094,4.726,15.538,60766,2.242,31.076,9026,9167,67907
1988,25,121947,143407,2816520,2781077,19170,13.655,13130,9.353,479054,171551,307503,6.169,17.225,408017,125068,282949,4.497,14.671,71037,2.554,29.342,9057,9223,64462
1989,25,123505,146114,2868807,2835161,18080,12.558,13789,9.578,487002,175736,311266,6.198,17.177,421644,129212,292432,4.557,14.872,65358,2.305,29.744,10235,10397,71923
1990,25,120599,143954,2786679,2832193,15361,10.644,16083,11.144,384347,150115,234232,5.3,13.571,475126,139021,336105,4.909,16.776,-90779,-3.205,27.141,11968,12207,75514
1991,25,115186,139577,2588448,2675225,14486,10.292,16836,11.961,325919,129581,196338,4.844,12.183,499238,159653,339585,5.968,18.662,-173319,-6.479,24.366,11797,12170,99910
1992,25,113155,137396,2556924,2561735,13675,9.933,14224,10.332,370212,131230,238982,5.123,14.452,378673,117320,261353,4.58,14.782,-8461,-0.33,28.903,9210,9434,61190
1993,25,114152,138120,2600603,2576393,14252,10.358,13204,9.596,409128,135504,273624,5.259,15.88,359438,116245,243193,4.512,13.951,49690,1.929,27.902,8532,8908,55784
1994,25,116138,140575,2639704,2624957,15103,10.84,12618,9.056,396429,129775,266654,4.944,15.102,366166,123856,242310,4.718,13.949,30263,1.153,27.899,8391,8577,58059
1995,25,118601,143800,2708567,2671039,16105,11.339,12565,8.847,411440,139762,271678,5.232,15.404,335486,116413,219073,4.358,12.56,75954,2.844,25.12,8410,8856,63829
1996,25,119363,144870,2705879,2691233,15154,10.536,13073,9.089,389706,128111,261595,4.76,14.481,361304,140207,221097,5.21,13.425,28403,1.055,26.85,8588,8901,66269
1997,25,121508,147471,2788487,2748805,16335,11.184,13498,9.242,462358,171587,290771,6.242,16.82,384179,134519,249660,4.894,13.976,78179,2.844,27.952,8679,8905,67671
1998,25,123372,149687,2877380,2845354,15031,10.111,12973,8.727,454356,147928,306428,5.199,15.968,387701,129897,257804,4.565,13.626,66655,2.343,27.252,8078,8265,53140
1999,25,125605,152250,2933286,2905946,16092,10.672,13166,8.732,448056,145174,302882,4.996,15.419,393845,129890,263955,4.47,13.553,54211,1.866,27.106,8348,8618,60919
2000,25,127038,154354,3040330,2990220,15776,10.3,13399,8.748,495801,156661,339140,5.239,16.581,396504,150046,246458,5.018,13.26,99297,3.321,26.52,8367,8750,62476
2001,25,127270,155198,3095812,3064926,15396,9.964,14048,9.091,486173,157784,328389,5.148,15.862,424074,140522,283552,4.585,13.836,62099,2.026,27.673,8871,9095,70000
2002,25,126587,155747,2983157,3048294,16606,10.685,15927,10.249,454532,173281,281251,5.685,14.911,585470,203231,382239,6.667,19.206,-130938,-4.295,29.822,9918,10170,97677
2003,25,128756,157714,2963244,2974590,16884,10.783,14612,9.332,417946,130111,287835,4.374,14.051,441566,156254,285312,5.253,14.845,-23620,-0.794,28.101,8581,8746,56000
2004,25,127597,156779,2971061,2968394,15496,9.86,16263,10.348,384386,130393,253993,4.393,12.949,380223,121533,258690,4.094,12.809,4163,0.14,25.618,11366,11527,59227
2005,25,126895,156676,2990384,2981468,15388,9.826,15242,9.733,377222,125938,251284,4.224,12.652,358159,120225,237934,4.032,12.013,19063,0.639,24.026,10082,10245,53757
2006,25,128547,159407,3062789,3026483,17146,10.86,14110,8.937,436591,149926,286665,4.954,14.426,366157,116059,250098,3.835,12.098,70434,2.327,24.197,9374,9531,57690
2007,25,127910,159388,3065553,3060142,15439,9.697,15102,9.485,410662,125897,284765,4.114,13.42,398608,120694,277914,3.944,13.026,12054,0.394,26.052,9372,9538,52142
2008,25,125864,157722,3065176,3063213,13749,8.679,15132,9.552,394725,118607,276118,3.872,12.886,391743,122862,268881,4.011,12.789,2982,0.097,25.577,9661,9814,53371
2009,25,122738,154511,2963455,3016304,12364,7.913,15821,10.126,318489,108579,209910,3.6,10.559,425925,115899,310026,3.842,14.121,-107436,-3.562,21.118,9536,9761,62149
2010,25,121196,153348,2931271,2947163,13245,8.612,14155,9.203,322365,102477,219888,3.477,10.938,352504,94610,257894,3.21,11.961,-30139,-1.023,21.876,8427,8637,45915
2011,25,121077,153665,2968974,2950189,13416,8.746,12885,8.4,333494,90399,243095,3.064,11.304,296079,81778,214301,2.772,10.036,37415,1.268,20.072,7692,7822,40049
2012,25,122509,154815,3031097,3000529,13973,9.069,12489,8.106,356629,88773,267856,2.959,11.886,295198,96023,199175,3.2,9.838,61431,2.047,19.676,7136,7356,44259
2013,25,122948,155475,3079995,3055518,13715,8.85,12713,8.203,347027,99759,247268,3.265,11.357,297849,93906,203943,3.073,9.748,49178,1.609,19.496,7507,7655,40393
2014,25,123708,156754,3090728,3077930,13526,8.671,11999,7.692,339671,107513,232158,3.493,11.036,316429,81655,234774,2.653,10.281,23242,0.755,20.561,7590,7801,42180
2015,25,124299,157785,3173974,3131739,13696,8.715,12442,7.917,372517,112099,260418,3.579,11.895,286977,90313,196664,2.884,9.164,85540,2.731,18.327,7709,7857,44992
2016,25,126526,161264,3238152,3204223,15046,9.437,11401,7.151,370544,107636,262908,3.359,11.564,305402,81313,224089,2.538,9.531,65142,2.033,19.062,7837,7981,45567
2017,25,127187,162183,3293149,3274276,14117,8.735,12979,8.031,397837,112405,285432,3.433,12.15,360833,110178,250655,3.365,11.02,37004,1.13,22.04,8362,8575,54662
2018,25,127751,162447,3351292,3316954,13290,8.194,12792,7.887,403705,125365,278340,3.78,12.171,333160,100132,233028,3.019,10.044,70545,2.127,20.088,9030,9228,50899
1978,26,127248,151689,2923860,2807821,20774,13.918,15910,10.659,557083,176085,380998,6.271,19.84,325504,149722,175782,5.332,11.593,231579,8.248,23.186,10389,10577,61361
1979,26,130080,155234,2999418,2925021,18947,12.399,14107,9.231,490277,150477,339800,5.144,16.761,339708,112112,227596,3.833,11.614,150569,5.148,23.228,9500,9659,53538
1980,26,128814,155149,2814843,2916539,17522,11.333,16453,10.641,344343,132558,211785,4.545,11.807,550274,122986,427288,4.217,18.867,-205931,-7.061,23.613,11270,11416,61605
1981,26,128292,155170,2711013,2762459,16783,10.86,15520,10.043,343380,143183,200197,5.183,12.43,446963,122662,324301,4.44,16.18,-103583,-3.75,24.86,9910,10147,52099
1982,26,126117,153522,2642400,2675442,17524,11.405,17791,11.578,389516,159172,230344,5.949,14.559,458178,136154,322024,5.089,17.125,-68662,-2.566,29.118,11708,12019,59237
1983,26,129949,157626,2590460,2597167,19525,12.635,13344,8.635,380985,149549,231436,5.758,14.669,393438,102038,291400,3.929,15.149,-12453,-0.479,29.339,8685,8904,48791
1984,26,135167,163214,2833251,2702194,20903,13.108,13422,8.416,537849,178373,359476,6.601,19.904,275156,99858,175298,3.695,10.183,262693,9.721,20.365,9398,9568,45954
1985,26,138071,166321,2967899,2891100,20907,12.775,15576,9.518,550526,214771,335755,7.429,19.042,398642,157810,240832,5.458,13.789,151884,5.254,27.577,11218,11451,71130
1986,26,140190,169592,3154895,3057432,21243,12.741,15523,9.31,557220,196520,360700,6.428,18.225,362157,116003,246154,3.794,11.845,195063,6.38,23.69,11143,11323,66191
1987,26,142592,173318,3147046,3155499,22407,13.147,16635,9.76,531048,193904,337144,6.145,16.829,546821,161193,385628,5.108,17.329,-15773,-0.5,33.659,11463,11637,75428
1988,26,147136,179566,3205301,3183528,22797,12.927,16359,9.277,521484,201557,319927,6.331,16.381,480710,154549,326161,4.855,15.1,40774,1.281,30.2,11168,11456,80031
1989,26,151071,185087,3336605,3264419,23025,12.683,15939,8.78,548515,177903,370612,5.45,16.803,405241,132340,272901,4.054,12.414,143274,4.389,24.828,11394,11785,71727
1990,26,153941,189047,3404222,3372069,21904,11.756,16447,8.827,524454,198020,326434,5.872,15.553,460524,131805,328719,3.909,13.657,63930,1.896,27.314,11976,12361,76756
1991,26,153842,190755,3249720,3314070,21413,11.329,17917,9.48,436667,170757,265910,5.152,13.176,567906,166960,400946,5.038,17.136,-131239,-3.96,26.352,12764,13129,98501
1992,26,153738,190997,3287112,3264291,19811,10.424,17929,9.434,495697,152480,343217,4.671,15.185,449552,132725,316827,4.066,13.772,46145,1.414,27.544,11856,12167,71322
1993,26,156621,193684,3381188,3335229,20337,10.587,17156,8.931,533820,170620,363200,5.116,16.006,442716,145922,296794,4.375,13.274,91104,2.732,26.548,11380,11739,67117
1994,26,159734,197668,3506036,3450463,21176,10.823,17172,8.776,538316,182059,356257,5.276,15.601,427942,150865,277077,4.372,12.402,110374,3.199,24.805,11925,12349,80293
1995,26,163720,202615,3666493,3583151,22517,11.265,17064,8.537,591367,205651,385716,5.739,16.504,426590,143607,282983,4.008,11.905,164777,4.599,23.811,11812,12118,78361
1996,26,165558,205607,3659644,3642628,21985,10.808,17614,8.659,520995,179969,341026,4.941,14.303,489524,146656,342868,4.026,13.439,31471,0.864,26.878,12451,12799,83502
1997,26,167088,206964,3769251,3724927,22434,10.888,20577,9.987,638191,210318,427873,5.646,17.133,544777,197855,346922,5.312,14.625,93414,2.508,29.25,13351,13844,91798
1998,26,168556,209302,3890513,3848214,21287,10.224,19096,9.172,595366,201538,393828,5.237,15.471,509807,166622,343185,4.33,13.248,85559,2.223,26.496,12513,13053,81647
1999,26,168467,210240,3961347,3927222,20455,9.765,18927,9.035,601250,212723,388527,5.417,15.31,531632,172989,358643,4.405,13.537,69618,1.773,27.074,12558,12911,84010
2000,26,168568,210656,4027297,4001688,20503,9.755,19562,9.307,619229,206849,412380,5.169,15.474,570038,212856,357182,5.319,14.245,49191,1.229,28.49,12267,12642,87629
2001,26,167470,210481,3969068,4001270,20722,9.858,20185,9.602,574310,199889,374421,4.996,14.353,637978,203327,434651,5.082,15.944,-63668,-1.591,28.706,12596,13035,89022
2002,26,165797,209703,3863023,3921422,22797,10.86,23244,11.072,627726,265581,362145,6.773,16.008,745606,254263,491343,6.484,19.014,-117880,-3.006,32.015,13921,14322,115414
2003,26,165856,209984,3844730,3853774,21139,10.085,20377,9.722,573102,193027,380075,5.009,14.871,592627,181982,410645,4.722,15.378,-19525,-0.507,29.742,12518,12915,88029
2004,26,166434,210092,3854471,3847689,20576,9.805,20095,9.576,541386,189748,351638,4.931,14.07,529089,184381,344708,4.792,13.751,12297,0.32,27.502,12240,12849,92075
2005,26,167012,211001,3767465,3812713,21414,10.178,20187,9.595,502010,186729,315281,4.898,13.167,591340,162480,428860,4.262,15.51,-89330,-2.343,26.333,12936,13211,84328
2006,26,167325,212804,3770779,3761257,23652,11.175,21329,10.078,533888,192801,341087,5.126,14.194,515174,164566,350608,4.375,13.697,18714,0.498,27.394,15096,15330,89241
2007,26,164701,210751,3663480,3715022,20829,9.853,22139,10.472,483731,164586,319145,4.43,13.021,586118,183928,402190,4.951,15.777,-102387,-2.756,26.042,14209,14566,93609
2008,26,160764,206749,3605558,3630742,18741,8.987,22303,10.695,492525,162177,330348,4.467,13.565,543355,181527,361828,5,14.965,-50830,-1.4,27.131,14603,14887,101403
2009,26,155307,200080,3367783,3491017,16370,8.042,23298,11.446,400221,145993,254228,4.182,11.464,647047,172398,474649,4.938,18.535,-246826,-7.07,22.929,14270,14531,90686
2010,26,151617,195888,3280115,3323688,15969,8.078,19579,9.904,390428,120258,270170,3.618,11.747,478367,144507,333860,4.348,14.393,-87939,-2.646,23.494,12133,12432,74022
2011,26,150837,195917,3376972,3327102,17789,9.091,17326,8.854,473176,127132,346044,3.821,14.222,372728,121157,251571,3.642,11.203,100448,3.019,22.406,10889,11184,61393
2012,26,151545,195809,3459748,3415619,17012,8.698,16586,8.48,470588,118657,351931,3.474,13.778,385022,134465,250557,3.937,11.272,85566,2.505,22.545,9752,10063,71507
2013,26,151304,195590,3514414,3477845,16348,8.364,16073,8.223,435063,125153,309910,3.599,12.51,361754,108497,253257,3.12,10.402,73309,2.108,20.803,10019,10136,58676
2014,26,151302,196245,3591570,3549384,16474,8.419,15352,7.845,441650,124677,316973,3.513,12.443,355714,111232,244482,3.134,10.022,85936,2.421,20.044,9897,10120,60422
2015,26,151994,198188,3716244,3658513,17829,9.05,15445,7.84,475927,145448,330479,3.976,13.009,359590,103969,255621,2.842,9.829,116337,3.18,19.658,9957,10225,59188
2016,26,153498,200940,3799340,3758132,17554,8.803,14476,7.26,457314,135451,321863,3.604,12.169,374760,109715,265045,2.919,9.972,82554,2.197,19.944,10030,10314,69418
2017,26,153208,200482,3846784,3818570,15992,7.975,16063,8.011,470214,121889,348325,3.192,12.314,414473,132298,282175,3.465,10.854,55741,1.46,21.708,10457,10820,67608
2018,26,153488,200711,3940414,3889859,15757,7.864,15065,7.519,490216,133205,357011,3.424,12.602,386259,118290,267969,3.041,9.93,103957,2.673,19.86,10999,11403,70653
1978,27,67813,79705,1347710,1278433,11287,14.47,7886,10.11,295997,92058,203939,7.201,23.153,158466,68730,89736,5.376,12.395,137531,10.758,24.791,5307,5387,27901
1979,27,70093,82256,1441349,1396590,10514,13.03,7385,9.152,272061,90239,181822,6.461,19.48,182586,67451,115135,4.83,13.074,89475,6.407,26.147,4914,4964,27720
1980,27,70123,82868,1458354,1448013,9537,11.597,8274,10.061,231046,84261,146785,5.819,15.956,210485,66708,143777,4.607,14.536,20561,1.42,29.072,5586,5675,33595
1981,27,70899,84079,1449427,1450692,9255,11.135,7334,8.824,210620,80275,130345,5.534,14.519,213107,57100,156007,3.936,14.69,-2487,-0.171,29.037,4891,5010,29446
1982,27,70610,84239,1437606,1442278,9747,11.644,8685,10.375,215531,87558,127973,6.071,14.944,224567,62487,162080,4.333,15.57,-9036,-0.627,29.888,5884,5984,30675
1983,27,72505,86152,1418266,1421321,9928,11.738,6782,8.019,221020,94672,126348,6.661,15.55,226790,59136,167654,4.161,15.956,-5770,-0.406,31.101,4485,4563,25340
1984,27,75689,89598,1516024,1462760,11699,13.408,7006,8.03,272303,90321,181982,6.175,18.616,166245,53754,112491,3.675,11.365,106058,7.251,22.73,4906,5021,28594
1985,27,76332,90449,1580095,1538832,11327,12.702,8776,9.841,285783,101103,184680,6.57,18.571,203997,77676,126321,5.048,13.257,81786,5.315,26.513,6334,6455,45984
1986,27,76521,91020,1591060,1576008,11168,12.425,8891,9.892,264339,100888,163451,6.401,16.773,233596,71427,162169,4.532,14.822,30743,1.951,29.644,6220,6361,41435
1987,27,77479,92583,1641858,1611017,11802,12.954,8848,9.712,293118,110543,182575,6.862,18.195,231417,82297,149120,5.108,14.365,61701,3.83,28.729,5972,6078,40748
1988,27,79662,95810,1711492,1681647,11995,12.747,8583,9.121,293592,113401,180191,6.743,17.459,234455,79956,154499,4.755,13.942,59137,3.517,27.884,5966,6088,43489
1989,27,81171,98066,1780428,1737678,11814,12.252,8535,8.851,302414,109390,193024,6.295,17.403,217876,83062,134814,4.78,12.538,84538,4.865,25.077,5943,6106,41849
1990,27,82928,100102,1827829,1799897,11423,11.593,8284,8.407,278968,92243,186725,5.125,15.499,221585,75492,146093,4.194,12.311,57383,3.188,24.622,5936,6075,40910
1991,27,83550,102097,1809381,1822217,12120,12.058,8947,8.902,266405,104751,161654,5.749,14.62,293350,87548,205802,4.804,16.099,-26945,-1.479,29.24,6289,6487,54013
1992,27,84332,103154,1849007,1824938,11327,11.101,9091,8.91,286624,95011,191613,5.206,15.706,238735,76967,161768,4.218,13.082,47889,2.624,26.164,5880,6053,40329
1993,27,86887,105741,1903250,1873512,11514,11.037,8674,8.315,287688,93569,194119,4.994,15.356,227639,74770,152869,3.991,12.15,60049,3.205,24.301,5609,5833,36486
1994,27,89338,108969,1969533,1943498,12056,11.227,8884,8.273,286846,94155,192691,4.845,14.759,235399,84863,150536,4.367,12.112,51447,2.647,24.224,6051,6214,48492
1995,27,91425,111489,2047480,2006552,11935,10.84,9163,8.322,300415,104778,195637,5.222,14.972,217977,69427,148550,3.46,10.863,82438,4.108,21.727,6216,6409,40139
1996,27,92944,113367,2076249,2052325,12048,10.751,9434,8.419,290981,98826,192155,4.815,14.178,242572,76188,166384,3.712,11.819,48409,2.359,23.639,6481,6650,44403
1997,27,94694,115602,2148632,2115353,12955,11.326,10513,9.191,341069,114061,227008,5.392,16.124,274812,95587,179225,4.519,12.991,66257,3.132,25.983,6737,6969,46826
1998,27,97090,118270,2251771,2212856,12218,10.441,9719,8.305,351782,110910,240872,5.012,15.897,274195,85974,188221,3.885,12.391,77587,3.506,24.782,6299,6449,41862
1999,27,98268,120204,2300299,2275186,12366,10.384,10123,8.501,336586,116883,219703,5.137,14.794,286168,99984,186184,4.395,12.578,50418,2.216,25.156,6528,6749,44467
2000,27,99282,121648,2369558,2337770,11996,9.931,10294,8.522,349807,110653,239154,4.733,14.963,285671,89358,196313,3.822,12.22,64136,2.743,24.44,6671,6881,43747
2001,27,99963,123643,2377292,2371169,13045,10.652,10681,8.722,334405,126800,207605,5.348,14.103,322898,103288,219610,4.356,13.618,11507,0.485,27.235,6775,6964,45932
2002,27,99855,124349,2346859,2371311,13882,11.199,13107,10.573,356150,131747,224403,5.556,15.019,404403,131600,272803,5.55,17.054,-48253,-2.035,30.038,7700,7943,63152
2003,27,101380,126188,2360951,2351780,13809,11.035,11709,9.357,348665,125090,223575,5.319,14.826,330659,104374,226285,4.438,14.06,18006,0.766,28.12,6942,7045,40471
2004,27,103147,128302,2373167,2367252,13677,10.756,11382,8.951,309954,95728,214226,4.044,13.093,298285,100479,197806,4.245,12.6,11669,0.493,25.201,7035,7205,42926
2005,27,104785,130424,2413828,2394789,13792,10.666,11555,8.936,320185,111533,208652,4.657,13.37,281462,83208,198254,3.475,11.753,38723,1.617,23.506,7354,7455,41559
2006,27,106136,133179,2467808,2440436,16108,12.238,12993,9.871,348001,122993,225008,5.04,14.26,292491,96653,195838,3.96,11.985,55510,2.275,23.97,8932,9075,52602
2007,27,105915,133248,2509735,2488853,13974,10.507,13484,10.138,366932,114146,252786,4.586,14.743,325694,102062,223632,4.101,13.086,41238,1.657,26.172,8104,8198,44628
2008,27,104066,131560,2481339,2495555,12263,9.272,13671,10.336,311985,100153,211832,4.013,12.502,341918,99722,242196,3.996,13.701,-29933,-1.199,25.003,8699,8909,49581
2009,27,101546,129153,2376261,2431603,11020,8.447,13640,10.455,268599,92137,176462,3.789,11.046,379518,86227,293291,3.546,15.608,-110919,-4.562,22.092,8379,8564,46925
2010,27,100384,128127,2350146,2362057,11009,8.566,11783,9.169,262715,83916,178799,3.553,11.122,285846,83770,202076,3.546,12.102,-23131,-0.979,22.245,7041,7179,38899
2011,27,99995,128187,2390435,2368833,11490,8.975,11157,8.715,273396,75514,197882,3.188,11.541,230262,65516,164746,2.766,9.72,43134,1.821,19.441,6981,7181,35537
2012,27,100429,128514,2456727,2422143,11243,8.771,10592,8.263,310221,75460,234761,3.115,12.808,239089,74926,164163,3.093,9.871,71132,2.937,19.742,6218,6414,40770
2013,27,100465,129007,2506235,2486179,11164,8.681,10355,8.052,301254,78888,222366,3.173,12.117,262137,68851,193286,2.769,10.544,39117,1.573,21.088,6263,6321,34087
2014,27,101035,130578,2556267,2529897,11496,8.864,9723,7.497,284568,79732,204836,3.152,11.248,231486,64160,167326,2.536,9.15,53082,2.098,18.3,6210,6347,38957
2015,27,101621,131909,2578588,2554146,11651,8.886,10072,7.682,299161,89621,209540,3.509,11.713,250635,68003,182632,2.662,9.813,48526,1.9,19.626,6352,6546,34565
2016,27,102505,134051,2626603,2600982,12017,9.045,9632,7.25,315714,96602,219112,3.714,12.138,263431,79769,183662,3.067,10.128,52283,2.01,20.256,6625,6761,43747
2017,27,102803,134446,2654688,2637170,11415,8.511,10764,8.026,328395,105227,223168,3.99,12.453,294462,92211,202251,3.497,11.166,33933,1.287,22.332,6951,7125,42165
2018,27,102324,133731,2728852,2688172,10304,7.694,10700,7.989,342961,112603,230358,4.189,12.758,261128,83041,178087,3.089,9.714,81833,3.044,19.428,7588,7863,51392
1978,28,35798,41788,596328,573101,6525,15.871,5172,12.58,126852,46930,79922,8.189,22.134,80241,35314,44927,6.162,14.001,46611,8.133,28.002,3517,3541,17316
1979,28,36782,43074,614466,605465,6278,14.842,4728,11.178,112367,42993,69374,7.101,18.559,93363,36409,56954,6.013,15.42,19004,3.139,30.84,3233,3264,17661
1980,28,36948,43520,609735,612747,5733,13.287,4989,11.563,99502,42069,57433,6.866,16.239,104943,30902,74041,5.043,17.127,-5441,-0.888,32.477,3656,3685,17418
1981,28,36773,43583,610131,611198,5169,11.914,4772,10.999,92147,36093,56054,5.905,15.076,94024,28335,65689,4.636,15.384,-1877,-0.307,30.153,3369,3422,15283
1982,28,35676,42669,599629,604148,5154,12.017,5594,13.043,91968,39580,52388,6.551,15.223,100726,33336,67390,5.518,16.672,-8758,-1.45,30.446,3865,3894,17644
1983,28,36285,43031,579061,583020,5610,13.22,4417,10.409,90846,33905,56941,5.815,15.582,97978,33760,64218,5.791,16.805,-7132,-1.223,31.164,2928,2979,14393
1984,28,38330,45424,641057,609119,6907,15.713,3975,9.043,136523,62873,73650,10.322,22.413,72465,24538,47927,4.028,11.897,64058,10.517,23.793,2962,3007,13994
1985,28,38357,45670,645396,640093,6114,13.537,5104,11.301,111528,44121,67407,6.893,17.424,101587,34106,67481,5.328,15.871,9941,1.553,31.741,3675,3731,19773
1986,28,38593,46008,668488,655511,5888,12.956,4765,10.485,125582,46410,79172,7.08,19.158,99094,32605,66489,4.974,15.117,26488,4.041,30.234,3331,3383,17445
1987,28,38630,46159,671789,671276,6115,13.384,5178,11.333,116864,46954,69910,6.995,17.409,116333,39789,76544,5.927,17.33,531,0.079,34.66,3537,3588,21591
1988,28,39147,47207,700196,687097,6201,13.304,5007,10.742,124379,53571,70808,7.797,18.102,97971,36279,61692,5.28,14.259,26408,3.843,28.517,3521,3575,20845
1989,28,39518,47897,717482,707595,6140,12.997,4831,10.226,118985,45749,73236,6.465,16.815,99458,35804,63654,5.06,14.056,19527,2.76,28.112,3482,3548,20453
1990,28,39987,48515,736498,725017,6020,12.558,4865,10.149,116863,43130,73733,5.949,16.119,94723,32187,62536,4.439,13.065,22140,3.054,26.13,3603,3686,21202
1991,28,39813,48849,740710,737607,5985,12.372,5036,10.41,116071,46423,69648,6.294,15.736,110052,34759,75293,4.712,14.92,6019,0.816,29.84,3572,3626,21292
1992,28,40047,49054,750376,742163,5470,11.245,4653,9.565,117010,35173,81837,4.739,15.766,100307,31249,69058,4.211,13.515,16703,2.251,27.031,3146,3213,17872
1993,28,41058,50137,783238,765704,5871,11.856,4637,9.364,134632,49306,85326,6.439,17.583,99601,38819,60782,5.07,13.008,35031,4.575,26.016,3270,3310,23485
1994,28,41717,51031,828611,807055,6027,11.92,5091,10.069,144532,55973,88559,6.935,17.909,100921,35174,65747,4.358,12.505,43611,5.404,25.01,3701,3784,19885
1995,28,42545,52164,858130,842257,6165,11.97,4848,9.413,142269,54869,87400,6.515,16.891,110446,38723,71723,4.598,13.113,31823,3.778,26.226,3502,3608,21721
1996,28,42948,52888,853740,851363,6136,11.719,5075,9.693,129956,53271,76685,6.257,15.264,124590,42525,82065,4.995,14.634,5366,0.63,29.268,3699,3765,24726
1997,28,43289,53550,886058,872670,6253,11.772,5385,10.138,149103,51137,97966,5.86,17.086,122227,38461,83766,4.407,14.006,26876,3.08,28.012,3721,3774,20958
1998,28,43738,54273,939327,925597,5997,11.128,5234,9.712,142804,48936,93868,5.287,15.428,115549,41785,73764,4.514,12.484,27255,2.945,24.967,3607,3693,21809
1999,28,43774,54615,945840,940663,6010,11.062,5437,10.008,141290,49492,91798,5.261,15.02,131624,48709,82915,5.178,13.993,9666,1.028,27.985,3806,3884,24046
2000,28,43256,54448,958506,951644,5590,10.279,5457,10.035,137898,51794,86104,5.443,14.491,123745,43706,80039,4.593,13.003,14153,1.487,26.007,3641,3738,21904
2001,28,42681,54051,926710,943202,5605,10.363,5678,10.498,124469,48025,76444,5.092,13.196,158149,56339,101810,5.973,16.767,-33680,-3.571,26.393,3619,3778,27886
2002,28,42922,54578,913109,921600,6197,11.423,5540,10.212,142201,56962,85239,6.181,15.43,159279,56600,102679,6.141,17.283,-17078,-1.853,30.86,3450,3527,27808
2003,28,43228,54973,916862,914252,5755,10.53,5120,9.368,139967,49214,90753,5.383,15.309,135003,43747,91256,4.785,14.767,4964,0.543,29.533,3318,3365,20592
2004,28,43536,55449,930804,923811,5527,10.029,4849,8.799,133421,44619,88802,4.83,14.442,118715,39737,78978,4.301,12.851,14706,1.592,25.701,3238,3296,18591
2005,28,43646,55801,925837,927706,5807,10.457,5269,9.488,125530,43612,81918,4.701,13.531,129050,42391,86659,4.569,13.911,-3520,-0.379,27.062,3416,3490,21976
2006,28,43362,55942,945268,935999,6644,11.926,6179,11.091,148929,57565,91364,6.15,15.911,131157,42509,88648,4.542,14.013,17772,1.899,28.025,4135,4208,22902
2007,28,44096,57075,938210,940899,6428,11.409,4960,8.804,131040,41721,89319,4.434,13.927,136093,39092,97001,4.155,14.464,-5053,-0.537,27.854,3262,3330,18460
2008,28,43613,56864,941816,938818,5280,9.289,5236,9.211,131204,41551,89653,4.426,13.975,125411,40181,85230,4.28,13.358,5793,0.617,26.717,3596,3686,19687
2009,28,42661,56011,901383,923568,4638,8.217,5508,9.758,104410,43062,61348,4.663,11.305,148956,43365,105591,4.695,16.128,-44546,-4.823,22.61,3703,3829,26469
2010,28,42118,55503,881046,890758,4494,8.077,4763,8.561,95447,32117,63330,3.606,10.715,114813,31204,83609,3.503,12.889,-19366,-2.174,21.431,3111,3198,17276
2011,28,41725,55373,893032,886531,4622,8.355,4518,8.167,107013,32905,74108,3.712,12.071,94135,26968,67167,3.042,10.618,12878,1.453,21.237,2976,3110,16151
2012,28,41362,55044,897604,896036,4345,7.889,4409,8.005,101107,29134,71973,3.251,11.284,97638,25528,72110,2.849,10.897,3469,0.387,21.793,2779,2843,14126
2013,28,41089,54805,896515,894501,4228,7.719,4159,7.594,96917,29264,67653,3.272,10.835,92593,25724,66869,2.876,10.351,4324,0.483,20.703,2709,2756,15515
2014,28,41046,55028,907214,901524,4354,7.942,3945,7.196,98668,30637,68031,3.398,10.945,87289,24413,62876,2.708,9.682,11379,1.262,19.365,2655,2709,13764
2015,28,40874,55017,924673,915648,4256,7.748,4082,7.431,113182,42042,71140,4.592,12.361,94346,26008,68338,2.84,10.304,18836,2.057,20.607,2742,2798,15806
2016,28,40912,55343,938870,931550,4420,8.023,3913,7.103,108995,34312,74683,3.683,11.7,94888,26338,68550,2.827,10.186,14107,1.514,20.372,2649,2717,13684
2017,28,40780,55272,935024,935399,4335,7.853,4196,7.601,105356,30027,75329,3.21,11.263,105724,31437,74287,3.361,11.303,-368,-0.039,22.526,2727,2801,14795
2018,28,40702,55210,942356,939998,4084,7.412,3871,7.025,100642,28411,72231,3.022,10.707,96253,26469,69784,2.816,10.24,4389,0.467,20.479,2733,2848,15835
1978,29,81196,96216,1569778,1505275,14136,14.917,11227,11.848,327497,112559,214938,7.478,21.757,198284,80653,117631,5.358,13.173,129213,8.584,26.345,7426,7567,36778
1979,29,83216,98505,1638131,1604029,13201,13.607,10220,10.535,280628,95266,185362,5.939,17.495,212482,80676,131806,5.03,13.247,68146,4.248,26.494,6742,6831,35645
1980,29,82588,98400,1626176,1635500,11654,11.89,10879,11.1,239663,92162,147501,5.635,14.654,257431,76475,180956,4.676,15.74,-17768,-1.086,29.308,7730,7861,39068
1981,29,83003,99241,1620008,1620831,11631,11.824,9890,10.054,240280,97827,142453,6.036,14.824,241325,74735,166590,4.611,14.889,-1045,-0.064,29.649,6537,6662,31482
1982,29,81146,97811,1609334,1613105,11519,11.757,11850,12.095,247820,97854,149966,6.066,15.363,254241,80736,173505,5.005,15.761,-6421,-0.398,30.726,8062,8225,37919
1983,29,83968,100555,1593130,1592554,13056,13.259,8884,9.022,250432,92103,158329,5.783,15.725,248842,71421,177421,4.485,15.625,1590,0.1,31.251,5805,5931,33481
1984,29,86735,103652,1686816,1633110,14271,14.093,9489,9.371,305085,105670,199415,6.47,18.681,198190,61988,136202,3.796,12.136,106895,6.545,24.271,6795,6889,33466
1985,29,88157,105222,1734373,1700557,14045,13.563,10712,10.344,304428,113020,191408,6.646,17.902,236645,97454,139191,5.731,13.916,67783,3.986,27.831,7709,7843,47814
1986,29,89081,107026,1785747,1752955,14423,13.727,10515,10.007,318419,125752,192667,7.174,18.165,252724,90404,162320,5.157,14.417,65695,3.748,28.834,7477,7664,47374
1987,29,90827,109555,1841721,1809675,15228,14.158,11240,10.45,351599,143677,207922,7.939,19.429,287005,92920,194085,5.135,15.859,64594,3.569,31.719,7645,7799,48105
1988,29,93213,113105,1867561,1847673,14981,13.474,11133,10.013,319384,121137,198247,6.556,17.286,279279,96238,183041,5.209,15.115,40105,2.171,30.23,7806,7938,47010
1989,29,95221,115869,1937644,1897711,14884,13.068,10932,9.598,335703,111416,224287,5.871,17.69,257900,87871,170029,4.63,13.59,77803,4.1,27.18,7808,8034,50862
1990,29,96836,117763,1982274,1956049,14154,12.178,11077,9.531,307466,110813,196653,5.665,15.719,254665,79083,175582,4.043,13.019,52801,2.699,26.039,7906,8140,48342
1991,29,96174,118466,1952108,1960233,14186,12.091,11910,10.151,283596,114328,169268,5.832,14.467,300222,98611,201611,5.031,15.316,-16626,-0.848,28.935,8466,8716,60699
1992,29,96780,119080,1997106,1980894,13408,11.353,11448,9.693,299882,103016,196866,5.2,15.139,267569,80979,186590,4.088,13.507,32313,1.631,27.015,7506,7661,40025
1993,29,98813,120968,2008866,1996920,13699,11.433,11402,9.516,297708,98896,198812,4.952,14.908,274315,94586,179729,4.737,13.737,23393,1.171,27.474,7604,7786,47290
1994,29,100915,123694,2074996,2045683,14796,12.101,11947,9.771,326694,112988,213706,5.523,15.97,268033,97137,170896,4.748,13.102,58661,2.868,26.205,8367,8588,56017
1995,29,102868,126199,2142071,2106626,14825,11.884,11923,9.558,342255,113718,228537,5.398,16.247,271894,96762,175132,4.593,12.907,70361,3.34,25.813,8403,8628,51934
1996,29,103546,127497,2143903,2128379,14240,11.268,11999,9.495,322519,114230,208289,5.367,15.153,291731,96139,195592,4.517,13.707,30788,1.447,27.413,8626,8783,49380
1997,29,103481,127700,2213400,2181771,14263,11.194,13690,10.745,364798,118344,246454,5.424,16.72,301211,104983,196228,4.812,13.806,63587,2.914,27.612,9317,9611,54913
1998,29,104512,129350,2283942,2265453,13936,10.842,12309,9.576,333862,119231,214631,5.263,14.737,297286,91694,205592,4.047,13.123,36576,1.615,26.245,8185,8387,46962
1999,29,104680,130183,2335383,2312378,13653,10.537,12442,9.602,350449,118314,232135,5.117,15.155,304288,107346,196942,4.642,13.159,46161,1.996,26.318,8371,8577,48877
2000,29,104735,130719,2374941,2356090,13544,10.397,12646,9.708,357053,118503,238550,5.03,15.154,319828,110378,209450,4.685,13.575,37225,1.58,27.149,8380,8596,48797
2001,29,103560,130311,2377677,2375200,12772,9.804,12692,9.743,334510,117397,217113,4.943,14.083,328576,108901,219675,4.585,13.834,5934,0.25,27.667,8377,8577,51564
2002,29,104293,131759,2338455,2368432,15637,11.938,14087,10.755,369472,148387,221085,6.265,15.6,428282,146597,281685,6.19,18.083,-58810,-2.483,31.2,8609,8860,74237
2003,29,105897,133580,2371911,2354145,15159,11.444,12935,9.765,343389,102702,240687,4.363,14.587,308450,101121,207329,4.295,13.102,34939,1.484,26.205,8324,8548,47782
2004,29,108208,136242,2399532,2381280,15748,11.685,12816,9.509,343167,119568,223599,5.021,14.411,306462,102488,203974,4.304,12.87,36705,1.541,25.739,8513,8638,48228
2005,29,110344,139133,2393187,2395823,16321,11.863,13209,9.601,308392,113091,195301,4.72,12.872,314473,87276,227197,3.643,13.126,-6081,-0.254,25.744,9104,9269,50257
2006,29,109772,140096,2442369,2416441,17310,12.424,15762,11.313,361094,137029,224065,5.671,14.943,307916,104612,203304,4.329,12.743,53178,2.201,25.485,11574,11782,57489
2007,29,109214,140524,2432643,2437417,15185,10.844,14207,10.145,334347,113287,221060,4.648,13.717,342558,105049,237509,4.31,14.054,-8211,-0.337,27.435,9401,9599,49806
2008,29,107558,139250,2442997,2436210,13363,9.566,14252,10.202,331383,112266,219117,4.608,13.602,317400,98906,218494,4.06,13.028,13983,0.574,26.057,9473,9606,45880
2009,29,105289,136912,2332487,2386696,12364,8.949,14870,10.762,258973,88798,170175,3.721,10.851,367996,108969,259027,4.566,15.419,-109023,-4.568,21.701,9768,9966,57139
2010,29,103684,135366,2273155,2302617,12992,9.579,13520,9.968,255087,90977,164110,3.951,11.078,314092,84366,229726,3.664,13.641,-59005,-2.563,22.156,8460,8699,42034
2011,29,101423,133713,2275743,2274248,12249,9.134,13022,9.711,251870,75843,176027,3.335,11.075,248090,71266,176824,3.134,10.909,3780,0.166,21.817,8718,8913,39256
2012,29,101306,133425,2309786,2292434,12579,9.432,12462,9.344,286651,83302,203349,3.634,12.504,252940,77347,175593,3.374,11.034,33711,1.471,22.067,7843,8208,37253
2013,29,103259,135624,2347111,2329190,13787,10.243,11729,8.714,278269,86888,191381,3.73,11.947,242007,75809,166198,3.255,10.39,36262,1.557,20.78,7381,7543,35704
2014,29,105570,138680,2392780,2369586,14911,10.876,11741,8.564,279255,83894,195361,3.54,11.785,232041,69741,162300,2.943,9.792,47214,1.993,19.585,7862,7972,36757
2015,29,107697,141348,2435381,2413112,15373,10.992,12395,8.862,308053,106653,201400,4.42,12.766,263973,86335,177638,3.578,10.939,44080,1.827,21.878,8116,8325,41339
2016,29,110006,144998,2490626,2462371,15718,10.986,11859,8.289,299428,97506,201922,3.96,12.16,242171,72816,169355,2.957,9.835,57257,2.325,19.67,8365,8492,40570
2017,29,110070,144743,2517945,2498907,14407,9.967,14028,9.704,321458,100105,221353,4.006,12.864,284151,97473,186678,3.901,11.371,37307,1.493,22.742,9290,9499,46147
2018,29,103895,138389,2529467,2519807,12812,9.303,11461,8.322,298050,91850,206200,3.645,11.828,277941,81785,196156,3.246,11.03,20109,0.798,22.061,8318,8564,45557
1978,30,17064,19460,197446,186095,3255,17.063,2488,13.042,51734,17693,34041,9.508,27.8,28907,14353,14554,7.713,15.533,22827,12.266,31.067,1730,1737,7646
1979,30,17890,20356,211742,204820,3276,16.51,2249,11.334,44969,17577,27392,8.582,21.955,31339,12014,19325,5.866,15.301,13630,6.655,30.602,1595,1606,7739
1980,30,17784,20203,206015,208946,2715,13.441,2707,13.402,37071,15597,21474,7.465,17.742,42951,14916,28035,7.139,20.556,-5880,-2.814,35.484,1826,1836,8914
1981,30,17901,20369,205382,205307,2646,13.11,2275,11.272,36817,13626,23191,6.637,17.933,37013,12257,24756,5.97,18.028,-196,-0.095,35.865,1537,1555,6432
1982,30,17709,20298,202181,203220,2860,14.161,2657,13.156,37920,16342,21578,8.042,18.66,39923,12324,27599,6.064,19.645,-2003,-0.986,37.319,1794,1808,8031
1983,30,18358,20973,202360,201380,2939,14.353,1945,9.499,39463,18227,21236,9.051,19.596,37620,11327,26293,5.625,18.681,1843,0.915,37.362,1327,1353,7504
1984,30,19285,21949,210086,205773,3326,15.596,2081,9.758,41548,18179,23369,8.834,20.191,32822,10000,22822,4.86,15.951,8726,4.241,31.901,1476,1494,6575
1985,30,19221,21818,206311,206844,2878,13.268,2625,12.102,35655,13332,22323,6.445,17.238,36654,13924,22730,6.732,17.721,-999,-0.483,34.475,1901,1912,8573
1986,30,18901,21587,201697,202965,2795,13.003,2610,12.143,33831,14383,19448,7.086,16.668,36372,12436,23936,6.127,17.92,-2541,-1.252,33.337,1894,1911,8733
1987,30,18877,21602,204392,202181,2974,13.888,2597,12.128,40933,17131,23802,8.473,20.246,36723,14173,22550,7.01,18.163,4210,2.082,36.327,1836,1863,8302
1988,30,19095,21927,206010,205829,2814,12.943,2443,11.237,38062,14926,23136,7.252,18.492,37776,14900,22876,7.239,18.353,286,0.139,36.706,1711,1726,8578
1989,30,19134,22024,215047,209748,2652,12.154,2245,10.288,39366,14725,24641,7.02,18.768,28865,10399,18466,4.958,13.762,10501,5.006,27.524,1627,1642,7191
1990,30,19532,22433,223522,219053,2603,11.766,1982,8.959,38235,12110,26125,5.528,17.455,29488,11141,18347,5.086,13.462,8747,3.993,26.923,1414,1430,5865
1991,30,19652,22805,225352,223624,2711,12.058,2066,9.189,37210,14677,22533,6.563,16.64,33600,10504,23096,4.697,15.025,3610,1.614,30.05,1488,1518,7423
1992,30,20094,23398,236918,230179,2943,12.817,2069,9.011,44742,14589,30153,6.338,19.438,31507,12098,19409,5.256,13.688,13235,5.75,27.376,1375,1404,6537
1993,30,20512,23822,242897,239727,2724,11.556,2226,9.443,40950,12878,28072,5.372,17.082,34426,11197,23229,4.671,14.361,6524,2.721,28.721,1513,1539,7236
1994,30,21240,24626,249352,246340,3001,12.389,2196,9.066,40687,15310,25377,6.215,16.517,34633,11561,23072,4.693,14.059,6054,2.458,28.118,1560,1582,7418
1995,30,21937,25436,260093,254075,3184,12.747,2267,9.076,42926,16489,26437,6.49,16.895,30897,10906,19991,4.292,12.161,12029,4.734,24.321,1617,1640,7411
1996,30,22440,25866,263114,260559,3131,12.245,2539,9.93,41642,16018,25624,6.148,15.982,36422,13473,22949,5.171,13.978,5220,2.003,27.957,1689,1715,8344
1997,30,22948,26386,269332,266469,3221,12.346,2626,10.066,47547,16980,30567,6.372,17.843,41840,15031,26809,5.641,15.702,5707,2.142,31.403,1763,1787,8297
1998,30,23491,27029,278378,275939,3318,12.42,2690,10.069,46177,17862,28315,6.473,16.735,41299,16206,25093,5.873,14.967,4878,1.768,29.933,1859,1899,8276
1999,30,23669,27298,287514,282119,3010,11.1,2650,9.772,47704,16166,31538,5.73,16.909,37019,13841,23178,4.906,13.122,10685,3.787,26.244,1814,1857,8428
2000,30,23908,27692,298490,293060,3115,11.347,2634,9.595,48631,15884,32747,5.42,16.594,37772,13395,24377,4.571,12.889,10859,3.705,25.778,1793,1829,8207
2001,30,24187,28122,306271,302300,3126,11.225,2579,9.261,48868,17858,31010,5.907,16.165,40776,12513,28263,4.139,13.489,8092,2.677,26.977,1691,1716,7998
2002,30,24275,28360,300273,302464,3255,11.533,2980,10.559,50011,19105,30906,6.316,16.535,54443,18526,35917,6.125,18,-4432,-1.465,33.069,1807,1833,10225
2003,30,24887,28996,304507,302238,3355,11.716,2633,9.195,47169,16706,30463,5.527,15.607,42715,13564,29151,4.488,14.133,4454,1.474,28.266,1661,1677,7433
2004,30,25706,29820,314890,309538,3632,12.37,2717,9.253,48658,16069,32589,5.191,15.72,37713,15150,22563,4.894,12.184,10945,3.536,24.367,1718,1749,8267
2005,30,26479,30708,327617,321665,3668,12.135,2703,8.943,52314,21480,30834,6.678,16.264,40440,11625,28815,3.614,12.572,11874,3.691,25.144,1790,1816,7321
2006,30,27515,31993,337759,332787,4631,14.801,3221,10.295,56688,22870,33818,6.872,17.034,46688,15251,31437,4.583,14.029,10000,3.005,28.059,2318,2343,10243
2007,30,28265,32917,353812,347729,4051,12.51,2981,9.206,58035,19816,38219,5.699,16.69,45609,14045,31564,4.039,13.116,12426,3.573,26.233,1972,1995,8403
2008,30,28116,32821,357990,355755,3368,10.264,3353,10.218,51319,15626,35693,4.392,14.425,46755,15318,31437,4.306,13.142,4564,1.283,26.285,2289,2320,9307
2009,30,27138,31801,339810,348922,2828,8.755,3828,11.851,38665,12149,26516,3.482,11.081,57059,14730,42329,4.222,16.353,-18394,-5.272,22.163,2425,2465,9344
2010,30,26777,31465,336779,338149,2938,9.3,3190,10.098,43123,16312,26811,4.824,12.753,45966,14129,31837,4.178,13.593,-2843,-0.841,25.505,2011,2038,9112
2011,30,26454,31191,334831,335629,3017,9.649,3171,10.141,40917,12431,28486,3.704,12.191,42316,13300,29016,3.963,12.608,-1399,-0.417,24.382,1958,2007,7937
2012,30,26753,31547,341725,338255,3243,10.358,2769,8.844,44996,13974,31022,4.131,13.302,37980,11652,26328,3.445,11.228,7016,2.074,22.456,1658,1686,6507
2013,30,26947,31769,348828,345010,3175,10.045,2850,9.017,45235,13852,31383,4.015,13.111,37619,12494,25125,3.621,10.904,7616,2.207,21.807,1807,1834,7627
2014,30,27099,32085,361574,354979,3123,9.797,2705,8.486,48518,14518,34000,4.09,13.668,35328,10569,24759,2.977,9.952,13190,3.716,19.904,1792,1807,7351
2015,30,27479,32548,371094,366323,3181,9.854,2648,8.203,48299,15300,32999,4.177,13.185,38266,11960,26306,3.265,10.446,10033,2.739,20.892,1809,1850,7299
2016,30,27685,32978,375110,372806,3162,9.661,2667,8.148,44278,16005,28273,4.293,11.877,40134,11514,28620,3.088,10.765,4144,1.112,21.531,1899,1906,8090
2017,30,27752,33039,376283,375227,2931,8.893,2770,8.405,48195,13354,34841,3.559,12.844,45562,14165,31397,3.775,12.143,2633,0.702,24.285,1878,1916,8735
2018,30,28033,33320,369787,372706,3106,9.37,2762,8.332,43533,14355,29178,3.852,11.68,50449,12887,37562,3.458,13.536,-6916,-1.856,23.361,2096,2122,8518
1978,31,31286,36065,454811,441544,4738,13.315,3778,10.617,89266,33009,56257,7.476,20.217,62555,25752,36803,5.832,14.167,26711,6.049,28.335,2635,2682,14116
1979,31,32184,36989,475373,464644,4476,12.292,3328,9.139,78921,25469,53452,5.481,16.985,57416,21803,35613,4.692,12.357,21505,4.628,24.714,2268,2288,11525
1980,31,32055,37062,478525,477481,4136,11.209,3807,10.318,72824,28073,44751,5.879,15.252,70930,20601,50329,4.315,14.855,1894,0.397,29.71,2815,2850,12473
1981,31,32240,37370,482852,480280,4008,10.809,3427,9.242,72184,27641,44543,5.755,15.03,67021,20704,46317,4.311,13.955,5163,1.075,27.909,2344,2380,10667
1982,31,31613,36785,473818,477604,3986,10.807,4182,11.339,67882,27832,40050,5.827,14.213,75726,23648,52078,4.951,15.855,-7844,-1.642,28.426,2836,2928,12665
1983,31,32379,37546,481906,474672,4303,11.674,2932,7.954,86729,41231,45498,8.686,18.271,71577,20192,51385,4.254,15.079,15152,3.192,30.159,1970,2001,10320
1984,31,33452,38749,506888,493129,4833,12.753,3126,8.249,87262,36252,51010,7.351,17.696,59526,18072,41454,3.665,12.071,27736,5.624,24.142,2305,2338,11337
1985,31,33081,38356,515186,508086,4388,11.488,4066,10.645,83435,33300,50135,6.554,16.421,69364,28435,40929,5.596,13.652,14071,2.769,27.304,3005,3043,15959
1986,31,32488,37824,515285,513327,3968,10.512,3814,10.104,75260,29005,46255,5.65,14.661,71363,21942,49421,4.274,13.902,3897,0.759,27.804,2762,2797,13493
1987,31,32323,37826,514491,522419,4181,11.144,3567,9.507,87018,32414,54604,6.205,16.657,105370,25173,80197,4.819,20.17,-18352,-3.513,33.314,2514,2556,13961
1988,31,33011,38911,538848,527050,4386,11.445,3210,8.376,92126,31759,60367,6.026,17.48,68704,24870,43834,4.719,13.036,23422,4.444,26.071,2270,2303,12826
1989,31,33339,39510,564696,549744,4413,11.32,3360,8.619,97018,36683,60335,6.673,17.648,67243,25037,42206,4.554,12.232,29775,5.416,24.463,2364,2430,14730
1990,31,33701,39986,585541,574093,4119,10.414,3251,8.22,86022,29370,56652,5.116,14.984,63132,20632,42500,3.594,10.997,22890,3.987,21.994,2324,2369,13236
1991,31,33677,40505,591023,587736,4301,10.748,3327,8.314,86385,32349,54036,5.504,14.698,80534,25753,54781,4.382,13.702,5851,0.996,27.405,2394,2445,18077
1992,31,33996,40852,595376,591266,4134,10.222,3312,8.19,82999,27865,55134,4.713,14.038,74950,23653,51297,4,12.676,8049,1.361,25.352,2205,2257,12967
1993,31,34431,41262,612337,603771,3988,9.727,3459,8.437,86249,26667,59582,4.417,14.285,68888,21545,47343,3.568,11.41,17361,2.875,22.819,2338,2414,11744
1994,31,35003,42081,630002,622028,4302,10.326,3466,8.319,89981,31623,58358,5.084,14.466,74139,27101,47038,4.357,11.919,15842,2.547,23.838,2447,2500,13721
1995,31,35417,42683,660906,644781,4123,9.742,3398,8.029,98462,34499,63963,5.35,15.271,66249,22191,44058,3.442,10.275,32213,4.996,20.549,2430,2484,12434
1996,31,35543,42927,674143,665601,4182,9.808,3606,8.457,94386,32445,61941,4.875,14.181,77232,27093,50139,4.07,11.603,17154,2.577,23.207,2546,2606,13679
1997,31,35829,43252,682508,677802,4401,10.235,3898,9.065,105514,39963,65551,5.896,15.567,96214,30362,65852,4.479,14.195,9300,1.372,28.39,2578,2657,16140
1998,31,36147,43773,713116,701841,4191,9.626,3720,8.544,105200,32726,72474,4.663,14.989,82316,29117,53199,4.149,11.729,22884,3.261,23.457,2536,2612,15050
1999,31,36282,44027,728813,721412,4019,9.165,3667,8.362,106685,32735,73950,4.538,14.788,91487,35161,56326,4.874,12.682,15198,2.107,25.363,2495,2587,20716
2000,31,36501,44500,751646,740208,4237,9.584,3656,8.27,112150,39142,73008,5.288,15.151,89550,28586,60964,3.862,12.098,22600,3.053,24.196,2343,2422,11872
2001,31,36571,44816,742876,746973,4281,9.596,3872,8.679,100481,40526,59955,5.425,13.452,109467,36406,73061,4.874,14.655,-8986,-1.203,26.904,2409,2493,15521
2002,31,36609,45144,740521,741783,4578,10.185,4191,9.324,113758,45086,68672,6.078,15.336,116455,35520,80935,4.788,15.699,-2697,-0.364,30.672,2531,2585,17634
2003,31,36970,45631,757912,748996,4414,9.737,3812,8.409,116231,36269,79962,4.842,15.518,98577,30296,68281,4.045,13.161,17654,2.357,26.322,2322,2361,11927
2004,31,37261,45937,755247,756211,4135,9.04,3745,8.187,93522,31834,61688,4.21,12.367,95084,24798,70286,3.279,12.574,-1562,-0.207,24.734,2380,2439,12970
2005,31,37689,46532,770389,763358,4377,9.47,3756,8.126,103517,32014,71503,4.194,13.561,89601,25782,63819,3.377,11.738,13916,1.823,23.476,2462,2518,13180
2006,31,37819,47121,784277,777372,5112,10.935,4364,9.335,103173,41159,62014,5.295,13.272,88832,27981,60851,3.599,11.427,14341,1.845,22.854,3077,3143,15758
2007,31,37861,47418,791257,787435,4477,9.486,4032,8.543,103329,32097,71232,4.076,13.122,96461,28920,67541,3.673,12.25,6868,0.872,24.5,2541,2556,13278
2008,31,37636,47356,794502,793450,4158,8.784,4120,8.704,100715,28381,72334,3.577,12.693,99287,26528,72759,3.343,12.513,1428,0.18,25.027,2669,2697,13355
2009,31,37366,47111,779159,787275,3685,7.798,3977,8.416,87210,29652,57558,3.766,11.077,103329,30627,72702,3.89,13.125,-16119,-2.047,22.155,2526,2581,15460
2010,31,37337,47233,770094,774537,3743,7.941,3542,7.515,79222,23955,55267,3.093,10.228,87931,20409,67522,2.635,11.353,-8709,-1.124,20.457,2166,2227,11556
2011,31,37106,47174,758976,757089,3862,8.191,3813,8.087,84847,24312,60535,3.211,11.207,80347,23640,56707,3.122,10.613,4500,0.594,21.225,2356,2405,11518
2012,31,37425,47488,774859,766226,3908,8.266,3492,7.386,94217,26340,67877,3.438,12.296,77357,20484,56873,2.673,10.096,16860,2.2,20.192,2109,2153,10364
2013,31,37391,47614,778051,776579,3833,8.072,3580,7.539,87336,23901,63435,3.078,11.246,84738,25841,58897,3.328,10.912,2598,0.335,21.823,2211,2237,12685
2014,31,37850,48241,794537,786213,3931,8.209,3220,6.724,86316,24584,61732,3.127,10.979,69379,20808,48571,2.647,8.824,16937,2.154,17.649,2019,2078,10114
2015,31,38148,48879,811269,802017,4103,8.456,3384,6.975,92312,29085,63227,3.626,11.51,74338,21114,53224,2.633,9.269,17974,2.241,18.538,2164,2202,11204
2016,31,38629,49629,825581,818310,4160,8.454,3315,6.737,88886,27806,61080,3.398,10.862,74628,21844,52784,2.669,9.12,14258,1.742,18.24,2181,2245,12083
2017,31,38843,49871,830896,827151,4067,8.184,3713,7.472,98371,28009,70362,3.386,11.893,90544,31124,59420,3.763,10.946,7827,0.946,21.893,2396,2452,16386
2018,31,38774,49669,842077,836511,3706,7.453,3815,7.672,96101,26600,69501,3.18,11.488,84815,28635,56180,3.423,10.139,11286,1.349,20.278,2689,2774,14554
1978,32,14463,16408,285079,262518,3406,21.588,2144,13.589,85269,32881,52388,12.525,32.481,39991,21822,18169,8.313,15.234,45278,17.248,30.467,1467,1479,11090
1979,32,15609,17777,325666,307624,3617,21.251,2103,12.356,86482,33916,52566,11.025,28.113,50873,24175,26698,7.859,16.537,35609,11.575,33.075,1427,1438,11226
1980,32,16129,18524,338207,331602,3384,18.742,2448,13.558,71812,32241,39571,9.723,21.656,57713,18798,38915,5.669,17.404,14099,4.252,34.809,1785,1813,11297
1981,32,16753,19327,351315,344443,3321,17.659,2280,12.123,76197,32460,43737,9.424,22.122,61903,17611,44292,5.113,17.972,14294,4.15,35.944,1516,1549,9850
1982,32,16885,19657,348371,348018,3302,17.031,2764,14.256,71428,31365,40063,9.012,20.524,69981,23838,46143,6.85,20.108,1447,0.416,40.217,1921,1937,14942
1983,32,17273,20072,336776,341711,3168,16.099,2380,12.095,60130,26937,33193,7.883,17.597,70374,17996,52378,5.266,20.595,-10244,-2.998,35.194,1602,1625,10418
1984,32,18375,21297,372402,353013,3700,18.02,2171,10.573,81334,31205,50129,8.84,23.04,42406,14018,28388,3.971,12.013,38928,11.027,24.025,1514,1529,8305
1985,32,18787,21692,387439,378033,3514,16.511,2695,12.663,78874,26880,51994,7.11,20.864,59984,26533,33451,7.019,15.867,18890,4.997,31.735,1882,1904,13918
1986,32,19091,22181,404975,395650,3694,17.034,2705,12.473,80480,31478,49002,7.956,20.341,61754,25490,36264,6.443,15.608,18726,4.733,31.216,1922,1951,13514
1987,32,19933,23153,441329,422187,4125,18.347,2785,12.387,104341,41641,62700,9.863,24.714,66397,24207,42190,5.734,15.727,37944,8.987,31.454,1861,1889,14349
1988,32,21077,24708,466597,454732,4334,18.154,2666,11.167,111094,40918,70176,8.998,24.431,88046,36363,51683,7.997,19.362,23048,5.068,38.724,1892,1915,15469
1989,32,22257,26105,507136,485022,4424,17.536,2670,10.583,118272,40979,77293,8.449,24.385,74337,29116,45221,6.003,15.327,43935,9.058,30.653,1880,1923,16281
1990,32,23366,27396,543273,522922,4479,16.861,2815,10.597,116221,37699,78522,7.209,22.225,75196,26025,49171,4.977,14.38,41025,7.845,28.76,2066,2095,18944
1991,32,24065,28609,536536,534372,4636,16.66,3072,11.04,98590,40494,58096,7.578,18.45,93247,27709,65538,5.185,17.45,5343,1,34.9,2181,2216,18171
1992,32,24431,29162,542180,536932,4360,15.237,3266,11.414,96473,41196,55277,7.672,17.967,85654,25483,60171,4.746,15.953,10819,2.015,31.905,2195,2220,14175
1993,32,25202,29786,561346,550949,4403,14.962,3687,12.529,101364,36102,65262,6.553,18.398,80632,31358,49274,5.692,14.635,20732,3.763,29.27,2343,2384,17206
1994,32,26645,31530,624989,597360,5129,16.739,3351,10.936,134426,46464,87962,7.778,22.503,77973,30685,47288,5.137,13.053,56453,9.45,26.106,2324,2373,20859
1995,32,28131,33303,662594,640837,5405,16.705,3509,10.845,123957,51398,72559,8.02,19.343,80791,25816,54975,4.028,12.607,43166,6.736,25.214,2515,2571,18901
1996,32,29075,34641,697319,676301,5558,16.422,3966,11.718,141763,61844,79919,9.144,20.962,100104,38194,61910,5.647,14.802,41659,6.16,29.603,2763,2815,22297
1997,32,30481,36512,748840,726845,6423,18.077,4461,12.555,156287,61569,94718,8.471,21.502,112666,40447,72219,5.565,15.501,43621,6.001,31.001,2906,2969,19873
1998,32,31957,38524,811496,786585,6249,16.647,4277,11.394,164683,72947,91736,9.274,20.936,114345,38271,76074,4.865,14.537,50338,6.4,29.074,2804,2835,18253
1999,32,33252,40547,852416,832367,6704,16.98,4572,11.58,173891,72083,101808,8.66,20.891,133807,51669,82138,6.207,16.075,40084,4.816,32.151,3012,3114,21991
2000,32,34262,41904,912271,882506,6555,15.922,5086,12.354,182403,67747,114656,7.677,20.669,122139,42229,79910,4.785,13.84,60264,6.829,27.68,3232,3297,21628
2001,32,34920,42865,933362,922049,6542,15.456,5463,12.907,163731,63706,100025,6.909,17.757,142548,48496,94052,5.26,15.46,21183,2.297,30.92,3549,3635,26462
2002,32,35522,44117,929481,932549,7016,16.145,5697,13.109,184045,80609,103436,8.644,19.736,190901,62812,128089,6.736,20.471,-6856,-0.735,39.471,3622,3699,29024
2003,32,37125,45973,968364,949514,7334,16.3,5378,11.952,174210,61487,112723,6.476,18.347,136482,44582,91900,4.695,14.374,37728,3.973,28.748,3463,3509,23015
2004,32,38598,47760,1020203,994607,7498,16.032,5517,11.796,183159,66082,117077,6.644,18.415,131969,51563,80406,5.184,13.268,51190,5.147,26.537,3567,3671,26518
2005,32,40237,49849,1081750,1050770,7986,16.398,5688,11.68,200728,71393,129335,6.794,19.103,138978,55768,83210,5.307,13.226,61750,5.877,26.453,3815,3896,31755
2006,32,42521,52977,1158495,1120656,9345,18.192,6131,11.935,221558,86681,134877,7.735,19.77,148222,49034,99188,4.375,13.226,73336,6.544,26.453,4448,4499,30211
2007,32,43603,54751,1184921,1172923,8605,16.003,6647,12.361,221201,81728,139473,6.968,18.859,197011,64554,132457,5.504,16.797,24190,2.062,33.593,4421,4467,29101
2008,32,43239,54748,1151690,1168320,7604,13.906,7470,13.661,179955,70874,109081,6.066,15.403,212903,62572,150331,5.356,18.223,-32948,-2.82,30.806,5174,5282,32950
2009,32,41667,53258,1041221,1097819,6602,12.212,8211,15.188,136628,55935,80693,5.095,12.445,250858,62053,188805,5.652,22.851,-114230,-10.405,24.891,5489,5639,36717
2010,32,40625,52273,995647,1019397,6472,12.279,7342,13.93,138212,59599,78613,5.846,13.558,185123,52725,132398,5.172,18.16,-46911,-4.602,27.116,4742,4843,31131
2011,32,40578,52373,996033,997435,6491,12.399,6450,12.32,133788,44126,89662,4.424,13.413,136491,46665,89826,4.679,13.684,-2703,-0.271,26.826,4279,4371,29416
2012,32,40918,52683,1013986,1004799,6449,12.289,6038,11.506,143385,48100,95285,4.787,14.27,124932,47709,77223,4.748,12.434,18453,1.836,24.867,3792,3946,27391
2013,32,41459,53249,1039825,1025857,6496,12.287,5732,10.842,154991,54233,100758,5.287,15.108,127472,47892,79580,4.668,12.426,27519,2.683,24.852,3720,3810,24916
2014,32,42477,54675,1083307,1062673,6925,12.844,5409,10.032,150772,51222,99550,4.82,14.188,108947,39231,69716,3.692,10.252,41825,3.936,20.504,3608,3646,21374
2015,32,43570,56287,1123159,1103018,7121,12.841,5455,9.837,164443,66013,98430,5.985,14.908,123153,38217,84936,3.465,11.165,41290,3.743,22.33,3675,3747,22929
2016,32,44714,57955,1158773,1143182,7173,12.563,5460,9.562,156872,55860,101012,4.886,13.722,126530,45134,81396,3.948,11.068,30342,2.654,22.136,3754,3847,29144
2017,32,45314,58698,1188366,1171946,6835,11.726,6021,10.329,168513,53234,115279,4.542,14.379,136870,50558,86312,4.314,11.679,31643,2.7,23.358,4053,4122,24912
2018,32,46488,59900,1218835,1203585,7056,11.906,5786,9.763,163293,57111,106182,4.745,13.567,133004,41867,91137,3.479,11.051,30289,2.517,22.101,4197,4321,25192
1978,33,17567,19594,289504,273430,3119,16.394,1982,10.418,63575,25895,37680,9.47,23.251,31811,12999,18812,4.754,11.634,31764,11.617,23.268,1391,1417,6570
1979,33,18274,20436,318573,304229,2876,14.415,1908,9.563,63983,21501,42482,7.067,21.031,35543,14256,21287,4.686,11.683,28440,9.348,23.366,1329,1340,6323
1980,33,18098,20290,324731,322206,2450,12.078,2441,12.033,52966,19549,33417,6.067,16.439,48470,17185,31285,5.334,15.043,4496,1.395,30.086,1602,1614,9409
1981,33,18506,20808,331492,328146,2630,12.844,1967,9.606,51213,19290,31923,5.878,15.607,44735,10858,33877,3.309,13.633,6478,1.974,27.265,1286,1323,5502
1982,33,18604,21078,343962,337145,2819,13.517,2372,11.374,65644,25148,40496,7.459,19.471,51955,19371,32584,5.746,15.41,13689,4.06,30.821,1600,1621,8519
1983,33,19345,21909,340301,338494,2954,13.834,1841,8.622,55018,20566,34452,6.076,16.254,50935,14176,36759,4.188,15.048,4083,1.206,30.095,1248,1267,7159
1984,33,20913,23601,383911,362259,3679,16.239,1788,7.892,81766,31593,50173,8.721,22.571,38735,13393,25342,3.697,10.693,43031,11.879,21.385,1285,1312,7479
1985,33,22255,25057,405931,392594,4027,16.656,2268,9.381,82410,28044,54366,7.143,20.991,55615,21759,33856,5.542,14.166,26795,6.825,28.332,1665,1690,13447
1986,33,23814,26812,423073,413561,4649,18.063,2501,9.717,86286,34848,51438,8.426,20.864,66349,25882,40467,6.258,16.043,19937,4.821,32.087,1835,1856,11459
1987,33,25505,28853,444338,438359,5108,18.421,2860,10.314,89528,35778,53750,8.162,20.423,77022,24968,52054,5.696,17.571,12506,2.853,35.141,2062,2094,14787
1988,33,26837,30482,467111,456519,4926,16.623,3230,10.9,91167,35407,55760,7.756,19.97,69903,24931,44972,5.461,15.312,21264,4.658,30.624,2392,2413,14657
1989,33,27121,30972,472999,469198,4345,14.222,3504,11.469,78033,30223,47810,6.441,16.631,70748,22793,47955,4.858,15.079,7285,1.553,30.157,2743,2777,15428
1990,33,26164,30146,454416,462399,3657,12.042,4104,13.514,67791,29707,38084,6.425,14.661,83548,27854,55694,6.024,18.068,-15757,-3.408,29.321,3183,3239,18121
1991,33,24930,29168,420020,435120,3452,11.723,4008,13.611,56805,26034,30771,5.983,13.055,86967,31447,55520,7.227,19.987,-30162,-6.932,26.11,2916,2969,18294
1992,33,24640,29055,422580,419270,3440,11.892,3182,11,68345,24659,43686,5.881,16.301,61726,18779,42947,4.479,14.722,6619,1.579,29.445,2192,2233,11009
1993,33,24901,29293,432340,427020,3357,11.525,3028,10.395,67728,22751,44977,5.328,15.861,57134,18319,38815,4.29,13.38,10594,2.481,26.759,2014,2070,9392
1994,33,25498,30003,453508,444021,3600,12.143,2886,9.735,73476,23622,49854,5.32,16.548,54528,20080,34448,4.522,12.281,18948,4.267,24.561,1949,1981,11340
1995,33,26334,30991,472625,461757,3798,12.469,2736,8.982,74410,27812,46598,6.023,16.115,52799,18156,34643,3.932,11.434,21611,4.68,22.869,1910,2001,11231
1996,33,26894,31655,478278,471188,3751,12.012,2895,9.271,70999,23348,47651,4.955,15.068,56813,19080,37733,4.049,12.057,14186,3.011,24.115,1962,2036,11518
1997,33,27381,32225,495650,488321,3749,11.749,3116,9.765,78706,25813,52893,5.286,16.118,64003,23320,40683,4.776,13.107,14703,3.011,26.213,2034,2079,11664
1998,33,28012,32820,521315,509824,3503,10.769,2918,8.971,83870,25487,58383,4.999,16.451,60923,20160,40763,3.954,11.95,22947,4.501,23.9,1872,1909,10282
1999,33,28304,33427,531945,525965,3469,10.481,2813,8.499,74194,25103,49091,4.773,14.106,62087,18818,43269,3.578,11.804,12107,2.302,23.609,1911,1961,10260
2000,33,28458,33652,558331,545431,3378,10.086,3061,9.139,93037,29872,63165,5.477,17.058,67779,24559,43220,4.503,12.427,25258,4.631,24.853,1907,1970,11893
2001,33,28541,33790,560519,557146,3361,9.985,3102,9.216,77378,27768,49610,4.984,13.888,70430,22997,47433,4.128,12.641,6948,1.247,25.282,1989,2064,11352
2002,33,28413,33928,548701,556981,3566,10.534,3413,10.082,79816,31162,48654,5.595,14.33,96318,32258,64060,5.792,17.293,-16502,-2.963,28.66,2161,2218,18855
2003,33,28520,34099,541147,544703,3484,10.255,3231,9.511,74376,25676,48700,4.714,13.654,80927,23782,57145,4.366,14.857,-6551,-1.203,27.309,2087,2129,12361
2004,33,29031,34724,550345,545836,3639,10.583,2961,8.611,68864,22037,46827,4.037,12.616,60221,20065,40156,3.676,11.033,8643,1.583,22.066,1967,2016,11342
2005,33,29351,35249,551885,550555,3724,10.653,3141,8.985,70843,27004,43839,4.905,12.868,67898,20718,47180,3.763,12.333,2945,0.535,24.665,2176,2198,12817
2006,33,29588,35749,571736,562463,3953,11.148,3372,9.51,84530,28470,56060,5.062,15.029,65909,20902,45007,3.716,11.718,18621,3.311,23.436,2389,2425,11150
2007,33,29417,35778,571296,571797,3578,10.017,3457,9.679,74261,22195,52066,3.882,12.987,75738,20575,55163,3.598,13.246,-1477,-0.258,25.975,2291,2307,11574
2008,33,28924,35331,588658,579360,3161,8.9,3536,9.955,92585,26352,66233,4.548,15.981,75124,22204,52920,3.833,12.967,17461,3.014,25.933,2356,2392,10651
2009,33,27998,34403,564142,577566,2778,7.962,3755,10.762,56938,17380,39558,3.009,9.858,84117,20328,63789,3.52,14.564,-27179,-4.706,19.717,2357,2401,12195
2010,33,27720,34099,561240,562316,2914,8.516,3151,9.209,66928,19886,47042,3.536,11.902,69234,17887,51347,3.181,12.312,-2306,-0.41,23.804,1942,1990,9749
2011,33,27343,33796,554930,558522,2798,8.251,3025,8.921,58111,17198,40913,3.079,10.404,64646,17549,47097,3.142,11.574,-6535,-1.17,20.809,1939,1967,9187
2012,33,27440,33959,547669,550721,3042,8.989,2809,8.3,61865,18645,43220,3.386,11.233,67500,27120,40380,4.924,12.257,-5635,-1.023,22.467,1688,1734,10169
2013,33,27367,34020,549934,548669,2873,8.463,2732,8.047,63215,19499,43716,3.554,11.522,60435,19751,40684,3.6,11.015,2780,0.507,22.03,1721,1745,8497
2014,33,27292,34254,563554,556414,2904,8.513,2623,7.689,65105,25082,40023,4.508,11.701,49986,15274,34712,2.745,8.984,15119,2.717,17.967,1694,1734,8063
2015,33,27278,34396,577049,570118,2803,8.173,2602,7.587,65013,18150,46863,3.184,11.403,51304,13730,37574,2.408,8.999,13709,2.405,17.998,1671,1699,8026
2016,33,27623,34982,594480,585724,3025,8.728,2380,6.867,66276,18886,47390,3.224,11.315,48846,13490,35356,2.303,8.339,17430,2.976,16.679,1676,1701,8009
2017,33,27467,34849,602725,597821,2627,7.53,2705,7.753,68659,19744,48915,3.303,11.485,59229,17495,41734,2.926,9.907,9430,1.577,19.815,1746,1777,9159
2018,33,27565,34941,612372,607467,2694,7.726,2550,7.313,69606,23051,46555,3.795,11.458,59814,16712,43102,2.751,9.846,9792,1.612,19.693,1897,1921,10002
1978,34,129423,146839,2410128,2344967,19424,13.401,15644,10.793,474956,160942,314014,6.863,20.254,343181,153191,189990,6.533,14.635,131775,5.619,29.27,10233,10322,66675
1979,34,133696,151713,2523537,2460578,19216,12.92,13254,8.911,446237,149295,296942,6.067,18.135,320078,111216,208862,4.52,13.008,126159,5.127,26.016,8649,8698,44893
1980,34,134803,153456,2545184,2535878,17717,11.663,14632,9.632,396668,137999,258669,5.442,15.642,378433,114478,263955,4.514,14.923,18235,0.719,29.846,10209,10293,54856
1981,34,136244,155481,2589690,2564849,17239,11.211,13820,8.987,407073,139435,267638,5.436,15.871,357747,106146,251601,4.138,13.948,49326,1.923,27.896,8615,8755,39322
1982,34,136298,156024,2610831,2597021,17702,11.423,15593,10.062,424729,154320,270409,5.942,16.354,397195,118438,278757,4.561,15.294,27534,1.06,30.589,10765,10894,52812
1983,34,140340,160229,2636337,2609468,19315,12.301,12908,8.22,442420,144928,297492,5.554,16.954,389508,109851,279657,4.21,14.927,52912,2.028,29.853,8837,8923,48316
1984,34,145040,165721,2801347,2706869,20753,12.814,13230,8.169,521353,167262,354091,6.179,19.26,332536,99713,232823,3.684,12.285,188817,6.975,24.57,9415,9518,51285
1985,34,148970,170239,2921817,2845868,22329,13.387,15449,9.262,546543,176164,370379,6.19,19.205,395387,135101,260286,4.747,13.893,151156,5.311,27.787,11168,11364,75037
1986,34,152488,173708,2953255,2918635,22641,13.284,16089,9.44,520547,178982,341565,6.132,17.835,449729,134133,315596,4.596,15.409,70818,2.426,30.818,11421,11558,66763
1987,34,157136,179546,3101910,3048983,25195,14.352,17193,9.794,628723,242142,386581,7.942,20.621,519555,160443,359112,5.262,17.04,109168,3.58,34.081,12181,12306,77791
1988,34,162883,187122,3180398,3157635,25698,14.028,17847,9.742,562447,209551,352896,6.636,17.812,518838,157087,361751,4.975,16.431,43609,1.381,32.862,13025,13180,79055
1989,34,165048,190338,3249892,3208657,24251,12.923,18900,10.071,570181,204152,366029,6.363,17.77,486986,146831,340155,4.576,15.177,83195,2.593,30.355,13870,14090,81234
1990,34,165079,191537,3257855,3248180,22913,12.064,19705,10.375,521072,199256,321816,6.134,16.042,502082,146767,355315,4.518,15.457,18990,0.585,30.915,14603,14784,85938
1991,34,160846,188351,3083135,3151118,21347,11.316,21946,11.633,447001,168338,278663,5.342,14.185,582085,169326,412759,5.374,18.472,-135084,-4.287,28.371,15602,15847,101951
1992,34,159267,186471,3047231,3057071,19935,10.699,19648,10.545,465956,143078,322878,4.68,15.242,485959,145287,340672,4.752,15.896,-20003,-0.654,30.484,13164,13331,74286
1993,34,161782,188694,3084897,3061862,21336,11.39,18597,9.928,504456,162786,341670,5.317,16.475,460793,149965,310828,4.898,15.049,43663,1.426,30.099,12446,12712,72124
1994,34,163629,191138,3106321,3097337,21710,11.435,19148,10.085,474847,163499,311348,5.279,15.331,456458,161808,294650,5.224,14.737,18389,0.594,29.474,12973,13256,82618
1995,34,167940,195981,3199749,3148672,23487,12.148,18205,9.416,518797,190859,327938,6.062,16.477,414276,146246,268030,4.645,13.157,104521,3.32,26.314,12708,12970,78599
1996,34,169260,197524,3168304,3166034,22618,11.531,19879,10.134,498459,179977,318482,5.685,15.744,496171,176479,319692,5.574,15.672,2288,0.072,31.343,13831,14096,80180
1997,34,171755,200208,3270174,3224908,24812,12.492,21633,10.892,607963,220026,387937,6.823,18.852,513014,203614,309400,6.314,15.908,94949,2.944,31.816,14261,14649,98752
1998,34,174728,203852,3389630,3350339,23409,11.586,19782,9.791,585755,196102,389653,5.853,17.483,507304,183811,323493,5.486,15.142,78451,2.342,30.284,12770,12974,78376
1999,34,175471,205192,3444396,3417712,22230,10.884,20338,9.958,551950,193626,358324,5.665,16.15,497200,169811,327389,4.969,14.548,54750,1.602,29.095,13336,13647,88872
2000,34,175890,206696,3533317,3484460,22302,10.841,20366,9.899,595385,194342,401043,5.577,17.087,498664,183811,314853,5.275,14.311,96721,2.776,28.622,13111,13409,78621
2001,34,176804,208561,3611583,3570322,22666,10.929,20321,9.799,595871,202527,393344,5.673,16.69,512006,170257,341749,4.769,14.341,83865,2.349,28.681,13165,13435,80156
2002,34,176372,209445,3580361,3603897,24180,11.578,22962,10.995,608811,220782,388029,6.126,16.893,655605,215893,439712,5.991,18.192,-46794,-1.298,33.786,14623,14928,104719
2003,34,176979,210149,3563443,3569528,23229,11.081,22184,10.583,551766,177495,374271,4.973,15.458,564408,187973,376435,5.266,15.812,-12642,-0.354,30.915,14253,14459,89929
2004,34,179440,211678,3607430,3588870,23739,11.261,22016,10.443,555932,171369,384563,4.775,15.49,520711,190706,330005,5.314,14.509,35221,0.981,29.018,13888,14057,81022
2005,34,181337,214025,3581514,3593758,24723,11.623,22106,10.392,505131,180790,324341,5.031,14.056,529902,189131,340771,5.263,14.745,-24771,-0.689,28.112,14649,14835,87159
2006,34,183941,218244,3661777,3622548,26692,12.36,22112,10.239,561236,207921,353315,5.74,15.493,482098,159585,322513,4.405,13.308,79138,2.185,26.617,15558,15705,78973
2007,34,183441,218160,3644997,3652649,24420,11.205,23989,11.007,532272,177968,354304,4.872,14.572,549355,180198,369157,4.933,15.04,-17083,-0.468,29.144,15779,15901,80361
2008,34,180134,215128,3591614,3614291,21385,9.879,24066,11.118,500743,167586,333157,4.637,13.855,546379,188710,357669,5.221,15.117,-45636,-1.263,27.709,16435,16625,91239
2009,34,173666,208697,3415010,3506864,19085,8.997,25951,12.234,392601,140654,251947,4.011,11.195,577092,162308,414784,4.628,16.456,-184491,-5.261,22.39,16986,17252,89866
2010,34,170366,205044,3356345,3385831,19420,9.396,22712,10.988,394050,137439,256611,4.059,11.638,453170,149163,304007,4.406,13.384,-59120,-1.746,23.276,14226,14417,76369
2011,34,169147,204018,3372925,3364186,20110,9.841,20784,10.171,419912,123787,296125,3.68,12.482,401891,131467,270424,3.908,11.946,18021,0.536,23.892,13426,13606,63825
2012,34,170951,205758,3431288,3403717,21412,10.461,19252,9.406,458038,135867,322171,3.992,13.457,403383,131563,271820,3.865,11.851,54655,1.606,23.703,12158,12371,63563
2013,34,171225,206362,3472610,3450343,20746,10.079,19688,9.565,466565,135540,331025,3.928,13.522,423135,144202,278933,4.179,12.264,43430,1.259,24.527,12735,12934,73114
2014,34,171212,207211,3502361,3486440,20673,10.006,19467,9.422,436466,147249,289217,4.223,12.519,403782,122886,280896,3.525,11.581,32684,0.937,23.163,13063,13240,66985
2015,34,170560,207175,3542609,3518897,19995,9.658,19714,9.522,469437,161682,307755,4.595,13.34,420149,140104,280045,3.981,11.94,49288,1.401,23.88,13308,13504,81886
2016,34,171839,209648,3621638,3583162,21084,10.122,18371,8.82,474639,147278,327361,4.11,13.246,396690,128513,268177,3.587,11.071,77949,2.175,22.142,13031,13170,73516
2017,34,171544,209712,3662061,3632845,20256,9.668,19859,9.479,503925,164224,339701,4.521,13.871,444509,138808,305701,3.821,12.236,59416,1.636,24.472,13621,13827,77211
2018,34,171508,209457,3720862,3692305,18861,9.005,18842,8.996,475274,148368,326906,4.018,12.872,418355,125507,292848,3.399,11.33,56919,1.542,22.661,14195,14381,67800
1978,35,22007,25499,306665,289830,4728,18.96,3603,14.449,83828,32310,51518,11.148,28.923,50637,25133,25504,8.672,17.471,33191,11.452,34.943,2532,2550,15482
1979,35,22812,26374,330149,319010,4381,16.96,3295,12.756,76642,29906,46736,9.375,24.025,54451,24011,30440,7.527,17.069,22191,6.956,34.138,2106,2135,11811
1980,35,22836,26573,328633,328664,4043,15.341,3605,13.679,64012,27515,36497,8.372,19.476,64242,22756,41486,6.924,19.546,-230,-0.07,38.953,2541,2570,14287
1981,35,23213,27079,335553,330815,3975,14.893,3199,11.985,69126,27390,41736,8.28,20.896,59485,20751,38734,6.273,17.981,9641,2.914,35.963,2126,2149,10203
1982,35,23398,27500,348272,341575,4236,15.599,3548,13.065,73971,29638,44333,8.677,21.656,60800,21210,39590,6.209,17.8,13171,3.856,35.6,2432,2461,12507
1983,35,24572,28725,341643,343550,4573,16.386,2940,10.534,67513,28261,39252,8.226,19.652,71110,21171,49939,6.162,20.699,-3597,-1.047,39.303,1981,2019,12772
1984,35,25772,29967,373182,357595,4845,16.626,3192,10.954,86655,39549,47106,11.06,24.233,55359,17928,37431,5.013,15.481,31296,8.752,30.962,2275,2310,11479
1985,35,26048,30256,399615,383893,4582,15.346,3786,12.68,96810,43980,52830,11.456,25.218,66108,27752,38356,7.229,17.22,30702,7.998,34.441,2660,2694,15811
1986,35,26115,30566,393814,394695,4642,15.405,3775,12.528,74679,33610,41069,8.515,18.921,76140,26623,49517,6.745,19.291,-1461,-0.37,37.841,2675,2719,15191
1987,35,26128,30678,389300,395520,4516,14.865,3922,12.909,83739,36828,46911,9.311,21.172,96481,26386,70095,6.671,24.393,-12742,-3.222,42.344,2631,2683,14823
1988,35,26556,31449,397219,393170,4647,14.988,3757,12.118,79878,31914,47964,8.117,20.316,71672,27348,44324,6.956,18.229,8206,2.087,36.459,2604,2654,16878
1989,35,26881,32016,406355,400611,4585,14.549,3580,11.36,77773,31199,46574,7.788,19.414,66082,24367,41715,6.082,16.495,11691,2.918,32.991,2559,2620,15083
1990,35,27478,32666,422987,413476,4474,13.918,3432,10.677,79641,32306,47335,7.813,19.261,60149,22419,37730,5.422,14.547,19492,4.714,29.094,2388,2441,13765
1991,35,27713,33190,428160,424499,4567,13.963,3604,11.019,82349,34808,47541,8.2,19.399,75453,28593,46860,6.736,17.775,6896,1.625,35.549,2482,2543,16320
1992,35,27952,33612,438796,431709,4329,13.052,3442,10.377,84285,32200,52085,7.459,19.524,70067,22386,47681,5.185,16.23,14218,3.293,32.46,2248,2290,12904
1993,35,28892,34387,457525,448280,4317,12.717,3435,10.119,85312,28157,57155,6.281,19.031,67020,23680,43340,5.282,14.95,18292,4.08,29.901,2236,2279,11741
1994,35,29821,35605,480654,470019,4767,13.628,3518,10.057,88927,31634,57293,6.73,18.92,67675,24070,43605,5.121,14.398,21252,4.522,28.797,2462,2501,14007
1995,35,30633,36590,502504,490727,4787,13.283,3685,10.225,89871,33930,55941,6.914,18.314,65891,25150,40741,5.125,13.427,23980,4.887,26.854,2601,2657,15023
1996,35,31025,37219,506874,500447,4704,12.788,3833,10.42,90269,32896,57373,6.573,18.038,77286,28092,49194,5.613,15.443,12983,2.594,30.887,2641,2684,15337
1997,35,31124,37633,515894,512115,4904,13.123,4375,11.708,96846,38892,57954,7.594,18.911,89520,31859,57661,6.221,17.48,7326,1.431,34.961,2891,2931,18828
1998,35,31503,38150,538338,533666,4528,11.944,4048,10.678,91474,34775,56699,6.516,17.141,82238,31266,50972,5.859,15.41,9236,1.731,30.82,2612,2693,14708
1999,35,31357,38361,540491,540388,4433,11.602,4127,10.801,87797,34212,53585,6.331,16.247,87257,29096,58161,5.384,16.147,540,0.1,32.294,2716,2777,16138
2000,35,31193,38370,553176,547859,4313,11.254,4223,11.019,92021,32176,59845,5.873,16.796,81574,29618,51956,5.406,14.89,10447,1.907,29.779,2759,2830,15483
2001,35,31172,38471,558035,555249,4447,11.599,4186,10.918,94082,34210,59872,6.161,16.944,88502,31255,57247,5.629,15.939,5580,1.005,31.878,2503,2560,14183
2002,35,31287,38668,552063,555879,4654,12.069,4443,11.522,98295,40230,58065,7.237,17.683,106502,35488,71014,6.384,19.159,-8207,-1.476,35.366,2586,2653,17428
2003,35,31728,39159,571115,561311,4432,11.404,3841,9.883,98869,36222,62647,6.453,17.614,79730,29549,50181,5.264,14.204,19139,3.41,28.409,2286,2339,12998
2004,35,32202,39695,581183,575841,4357,11.063,3735,9.484,91395,31017,60378,5.386,15.872,80639,28816,51823,5.004,14.004,10756,1.868,28.007,2368,2399,12429
2005,35,32733,40504,599133,594239,4602,11.487,3722,9.29,101009,36675,64334,6.172,16.998,91869,24868,67001,4.185,15.46,9140,1.538,30.92,2400,2453,15043
2006,35,33541,41644,631966,615375,5431,13.238,4197,10.23,113606,43197,70409,7.02,18.461,80145,28877,51268,4.693,13.024,33461,5.438,26.048,2921,2957,16872
2007,35,33969,42409,631450,630827,4838,11.531,3930,9.367,98928,33418,65510,5.297,15.682,96815,29013,67802,4.599,15.347,2113,0.335,30.695,2546,2588,14573
2008,35,33714,42198,637315,637979,4308,10.195,4420,10.461,96778,35005,61773,5.487,15.169,98057,32820,65237,5.144,15.37,-1279,-0.2,30.339,2810,2872,16114
2009,35,32864,41420,611902,625150,3677,8.786,4534,10.834,73565,25832,47733,4.132,11.768,100232,25961,74271,4.153,16.033,-26667,-4.266,23.535,2953,2994,15129
2010,35,31997,40553,596211,603678,3492,8.531,4252,10.388,68105,21600,46505,3.578,11.282,83080,22301,60779,3.694,13.762,-14975,-2.481,22.563,2722,2770,12543
2011,35,31670,40407,594059,594592,3772,9.33,3818,9.443,70092,21325,48767,3.586,11.788,70908,18794,52114,3.161,11.925,-816,-0.137,23.577,2495,2567,11343
2012,35,31642,40347,591738,592860,3695,9.165,3630,9.004,74546,23701,50845,3.998,12.574,76777,24098,52679,4.065,12.95,-2231,-0.376,25.148,2207,2313,10452
2013,35,31494,40197,592771,591939,3594,8.939,3616,8.993,80046,28839,51207,4.872,13.523,78222,24338,53884,4.112,13.215,1824,0.308,26.429,2284,2321,12946
2014,35,31314,40226,616093,604341,3496,8.703,3385,8.427,87965,40272,47693,6.664,14.556,65397,19796,45601,3.276,10.821,22568,3.734,21.642,2254,2281,10687
2015,35,31180,40381,626331,620547,3646,9.055,3410,8.469,77371,27197,50174,4.383,12.468,65782,19246,46536,3.101,10.601,11589,1.868,21.201,2188,2210,10113
2016,35,31055,40462,629749,628014,3509,8.688,3361,8.322,74441,26675,47766,4.248,11.853,71242,20768,50474,3.307,11.344,3199,0.509,22.688,2251,2326,12259
2017,35,30965,40294,625361,626422,3366,8.344,3454,8.563,75006,23076,51930,3.684,11.974,76718,23858,52860,3.809,12.247,-1712,-0.273,23.947,2251,2304,11307
2018,35,30882,40053,629511,627472,3228,8.043,3395,8.459,71716,22396,49320,3.569,11.429,67384,20915,46469,3.333,10.739,4332,0.69,21.478,2420,2479,11899
1978,36,313646,353875,5572948,5468658,44241,12.559,41003,11.64,1039669,350285,689384,6.405,19.011,827866,356225,471641,6.514,15.138,211803,3.873,30.277,28679,29016,146324
1979,36,316929,357902,5808848,5668907,42071,11.895,33648,9.513,1002402,310518,691884,5.478,17.682,721417,256894,464523,4.532,12.726,280985,4.957,25.452,23197,23479,118015
1980,36,314591,356391,5791762,5776126,39205,11.05,36008,10.149,858491,285615,572876,4.945,14.863,828672,266436,562236,4.613,14.347,29819,0.516,28.693,26053,26355,144751
1981,36,317325,360203,5859478,5817500,39123,10.983,31155,8.746,894776,290846,603930,5,15.381,809381,219334,590047,3.77,13.913,85395,1.468,27.826,20577,20942,96072
1982,36,315908,359573,5929882,5885417,40444,11.303,36936,10.323,941572,345808,595764,5.876,15.998,852897,261356,591541,4.441,14.492,88675,1.507,28.983,26343,26732,136224
1983,36,324328,368204,5953748,5919907,44800,12.402,30855,8.542,964478,334539,629939,5.651,16.292,896635,240199,656436,4.057,15.146,67843,1.146,30.292,22147,22460,127417
1984,36,330802,375412,6222961,6094837,45692,12.382,32902,8.916,1051723,352929,698794,5.791,17.256,795845,219902,575943,3.608,13.058,255878,4.198,26.115,24414,24671,130797
1985,36,336474,381804,6383009,6254211,49125,13.089,36168,9.636,1106463,383339,723124,6.129,17.691,849366,288594,560772,4.614,13.581,257097,4.111,27.161,27348,27732,166914
1986,36,339663,385526,6511041,6407295,48224,12.694,36956,9.728,1101331,385407,715924,6.015,17.189,895557,290693,604864,4.537,13.977,205774,3.212,27.954,27414,27766,148814
1987,36,343808,391397,6729860,6607384,51705,13.412,39912,10.353,1238614,476213,762401,7.207,18.746,990177,319614,670563,4.837,14.986,248437,3.76,29.972,29600,29877,177105
1988,36,352903,403423,6838164,6793253,53010,13.353,40159,10.116,1163140,392560,770580,5.779,17.122,1070004,329854,740150,4.856,15.751,93136,1.371,31.502,30109,30462,173307
1989,36,357219,409852,6940341,6868090,52798,13.069,41097,10.172,1124521,399182,725339,5.812,16.373,982736,313038,669698,4.558,14.309,141785,2.064,28.617,30951,31504,176555
1990,36,356767,411799,6995895,6955713,49231,12.054,42502,10.406,1048071,365130,682941,5.249,15.068,966269,298336,667933,4.289,13.892,81802,1.176,27.783,32767,33284,186039
1991,36,350076,408505,6683559,6835067,47466,11.652,45206,11.097,911462,372340,539122,5.447,13.335,1217134,352497,864637,5.157,17.807,-305672,-4.472,26.67,34175,34773,233265
1992,36,344819,403009,6582793,6603998,43570,10.815,43294,10.746,954527,323569,630958,4.9,14.454,996088,300097,695991,4.544,15.083,-41561,-0.629,28.908,31114,31542,172327
1993,36,345471,403195,6520890,6539472,44966,11.168,43864,10.894,969392,339103,630289,5.185,14.824,1006815,326439,680376,4.992,15.396,-37423,-0.572,29.647,30839,31432,170764
1994,36,346143,405230,6593958,6566685,45538,11.266,43461,10.753,1000350,354192,646158,5.394,15.234,946591,336907,609684,5.131,14.415,53759,0.819,28.83,31024,31591,190599
1995,36,350733,410663,6639226,6604666,47360,11.621,41123,10.09,976657,348057,628600,5.27,14.787,905290,294713,610577,4.462,13.707,71367,1.081,27.414,29620,30209,175418
1996,36,351765,412083,6609469,6597357,46706,11.383,43143,10.515,962740,351544,611196,5.329,14.593,938370,322192,616178,4.884,14.223,24370,0.369,28.447,31177,31892,189041
1997,36,355074,415580,6760360,6702531,49433,11.954,45326,10.961,1112502,381863,730639,5.697,16.598,994961,379882,615079,5.668,14.845,117541,1.754,29.689,31902,32555,195743
1998,36,360691,422479,6926180,6860558,46631,11.129,39658,9.465,1135173,357253,777920,5.207,16.546,1001964,334370,667594,4.874,14.605,133209,1.942,29.209,26632,27066,146113
1999,36,362450,426360,7037102,6982006,45278,10.679,40517,9.556,1052164,349852,702312,5.011,15.07,941687,318616,623071,4.563,13.487,110477,1.582,26.975,27530,28034,163778
2000,36,364906,430622,7268436,7164084,45699,10.674,40695,9.506,1143430,376654,766776,5.258,15.961,932324,347282,585042,4.848,13.014,211106,2.947,26.028,26777,27409,159791
2001,36,367227,433655,7273133,7257680,46186,10.703,41888,9.707,1039332,362928,676404,5.001,14.32,1009551,348478,661073,4.802,13.91,29781,0.41,27.82,27002,27526,167777
2002,36,367665,436113,7169100,7264493,50818,11.684,48445,11.139,1175935,490863,685072,6.757,16.187,1367618,518871,848747,7.143,18.826,-191683,-2.639,32.375,30722,31379,237273
2003,36,372615,440848,7261834,7208222,49085,11.204,43609,9.954,1097904,340787,757117,4.728,15.231,989154,320022,669132,4.44,13.723,108750,1.509,27.445,28709,29193,156727
2004,36,377705,446773,7354261,7322203,51159,11.533,44755,10.09,1059369,346569,712800,4.733,14.468,995682,322985,672697,4.411,13.598,63687,0.87,27.196,29636,30094,162998
2005,36,382380,450154,7337994,7347032,50498,11.268,46531,10.382,993612,363770,629842,4.951,13.524,1012151,330406,681745,4.497,13.776,-18539,-0.252,27.048,30642,31042,171346
2006,36,386173,457030,7484385,7416389,54246,11.97,46551,10.272,1064712,379144,685568,5.112,14.356,928353,299206,629147,4.034,12.518,136359,1.839,25.035,33726,34102,176958
2007,36,387516,459696,7475105,7475868,51247,11.195,47380,10.35,1057653,354839,702814,4.746,14.148,1056046,359959,696087,4.815,14.126,1607,0.021,28.252,31755,32068,170288
2008,36,387820,460926,7538790,7501739,48196,10.479,46187,10.042,1025762,331149,694613,4.414,13.674,951823,304465,647358,4.059,12.688,73939,0.986,25.376,31464,31803,163466
2009,36,384382,457876,7287945,7419594,45430,9.879,49437,10.75,825372,292394,532978,3.941,11.124,1089459,314070,775389,4.233,14.684,-264087,-3.559,22.248,32831,33223,178438
2010,36,385281,459169,7220321,7254209,47599,10.388,45672,9.968,853774,303565,550209,4.185,11.769,921535,285949,635586,3.942,12.703,-67761,-0.934,23.539,30287,30732,153524
2011,36,387562,462468,7337002,7277791,49303,10.707,45296,9.837,940410,299619,640791,4.117,12.922,820947,270199,550748,3.713,11.28,119463,1.641,22.56,29968,30345,140581
2012,36,393611,468780,7501682,7415412,49958,10.739,42766,9.193,969770,288087,681683,3.885,13.078,796314,254775,541539,3.436,10.739,173456,2.339,21.477,28504,28958,138013
2013,36,396498,471260,7627726,7565350,48763,10.385,45314,9.651,974000,305873,668127,4.043,12.874,848456,281660,566796,3.723,11.215,125544,1.659,22.43,29685,30149,155331
2014,36,399074,475457,7812343,7722282,49237,10.41,44252,9.356,1013525,347862,665663,4.505,13.125,834124,267117,567007,3.459,10.802,179401,2.323,21.603,30613,30937,150568
2015,36,400948,478048,7965508,7888667,48259,10.129,45055,9.456,1031375,345427,685948,4.379,13.074,878616,287232,591384,3.641,11.138,152759,1.936,22.275,30822,31297,155918
2016,36,405431,484732,8132656,8046386,50415,10.48,43110,8.961,1015866,313244,702622,3.893,12.625,844059,294359,549700,3.658,10.49,171807,2.135,20.98,31503,31912,183490
2017,36,405839,485443,8221108,8168696,47560,9.812,46117,9.514,1072469,325839,746630,3.989,13.129,967129,340602,626527,4.17,11.839,105340,1.29,23.679,32823,33264,182830
2018,36,406140,485122,8337528,8271995,45821,9.449,45434,9.369,1034208,318755,715453,3.853,12.503,904363,299052,605311,3.615,10.933,129845,1.57,21.866,34904,35544,189152
1978,37,88747,106887,1856385,1786906,15989,15.27,11626,11.104,348927,124311,224616,6.957,19.527,209810,84607,125203,4.735,11.742,139117,7.785,23.483,7762,7834,35351
1979,37,91847,110926,1970780,1917708,15117,13.92,10462,9.634,328786,118882,209904,6.199,17.145,221976,84299,137677,4.396,11.575,106810,5.57,23.15,7265,7356,39068
1980,37,91684,111586,1978505,1977190,13742,12.392,12354,11.141,283466,110777,172689,5.603,14.337,278438,96319,182119,4.872,14.083,5028,0.254,28.165,8595,8740,44215
1981,37,92310,112886,1989082,1981795,13368,11.951,11312,10.113,277466,111795,165671,5.641,14.001,261260,83062,178198,4.191,13.183,16206,0.818,26.366,7574,7696,36723
1982,37,92021,113383,1990308,1990336,14139,12.547,12753,11.317,289077,124128,164949,6.237,14.524,288322,88573,199749,4.45,14.486,755,0.038,28.972,8811,8985,41162
1983,37,94143,115928,1998191,1990732,15043,13.209,10948,9.614,303126,121231,181895,6.09,15.227,285769,95180,190589,4.781,14.355,17357,0.872,28.71,7738,7882,37585
1984,37,101520,124053,2167146,2082507,20239,16.888,11813,9.857,387123,132252,254871,6.351,18.589,218172,77750,140422,3.733,10.476,168951,8.113,20.953,9164,9235,48230
1985,37,105232,128186,2254158,2205190,17703,14.124,12016,9.587,381634,138857,242777,6.297,17.306,284137,99074,185063,4.493,12.885,97497,4.421,25.77,8610,8774,53530
1986,37,108186,132066,2323402,2282489,18267,14.148,12359,9.572,383314,147917,235397,6.481,16.794,302900,105758,197142,4.633,13.271,80414,3.523,26.541,8631,8801,50111
1987,37,110979,136765,2421694,2371582,19300,14.441,13071,9.78,435829,171404,264425,7.227,18.377,337116,131293,205823,5.536,14.215,98713,4.162,28.43,9036,9159,58240
1988,37,115460,143338,2549346,2490427,20242,14.47,13344,9.539,457195,186329,270866,7.482,18.358,338493,118472,220021,4.757,13.592,118702,4.766,27.184,9083,9278,57277
1989,37,118682,147411,2628141,2583764,19476,13.477,13678,9.465,432322,169803,262519,6.572,16.732,345331,117222,228109,4.537,13.365,86991,3.367,26.731,9399,9641,57325
1990,37,121682,151360,2706507,2662087,19073,12.829,13687,9.206,423933,151563,272370,5.693,15.925,335927,104869,231058,3.939,12.619,88006,3.306,25.238,9858,10125,59030
1991,37,120573,151896,2602102,2646424,18040,11.964,15819,10.491,355145,150643,204502,5.692,13.42,445146,142853,302293,5.398,16.821,-90001,-3.401,26.84,11158,11468,79750
1992,37,120962,152680,2648472,2612313,16890,11.155,14363,9.486,405815,139890,265925,5.355,15.535,333838,101675,232163,3.892,12.779,71977,2.755,25.559,9484,9692,51929
1993,37,123490,155217,2716705,2681273,17093,11.123,14016,9.12,411975,129312,282663,4.823,15.365,340812,114823,225989,4.282,12.711,71163,2.654,25.422,9246,9465,59024
1994,37,127118,160002,2847413,2788095,18758,11.907,13832,8.78,442833,156902,285931,5.628,15.883,324440,108569,215871,3.894,11.637,118393,4.246,23.273,9496,9738,59233
1995,37,131525,165490,2967595,2904685,19635,12.083,13647,8.398,456398,156101,300297,5.374,15.712,328509,110514,217995,3.805,11.31,127889,4.403,22.619,9458,9727,57318
1996,37,134495,169395,3012998,2980042,20051,12.015,15030,9.006,454269,173767,280502,5.831,15.244,388337,129931,258406,4.36,13.031,65932,2.212,26.063,10062,10320,60536
1997,37,138439,175469,3112374,3063619,23029,13.377,16390,9.521,521598,194233,327365,6.34,17.026,423777,150773,273004,4.921,13.833,97821,3.193,27.665,10608,10898,71174
1998,37,141566,178996,3224378,3183613,21210,11.972,17534,9.897,512343,189527,322816,5.953,16.093,430465,162613,267852,5.108,13.521,81878,2.572,27.043,10710,10982,66939
1999,37,143832,182354,3324593,3276143,21078,11.69,16989,9.422,556138,198131,358007,6.048,16.975,458423,163350,295073,4.986,13.993,97715,2.983,27.986,10970,11393,71988
2000,37,144530,183948,3402651,3363780,19786,10.823,17526,9.587,527309,181103,346206,5.384,15.676,451623,163630,287993,4.864,13.426,75686,2.25,26.852,11286,11821,73459
2001,37,145499,185598,3440457,3421401,20824,11.296,18340,9.948,555299,195955,359344,5.727,16.23,513374,175853,337521,5.14,15.005,41925,1.225,30.01,11374,11840,74043
2002,37,145665,187011,3323743,3388181,21768,11.693,20060,10.776,508862,211537,297325,6.243,15.019,635086,208544,426542,6.155,18.744,-126224,-3.725,30.037,12086,12506,92791
2003,37,146908,188661,3340217,3331327,20855,11.12,18632,9.934,512059,178923,333136,5.371,15.371,495728,163586,332142,4.911,14.881,16331,0.49,29.762,11363,11576,66377
2004,37,149751,191945,3357286,3345354,21132,11.116,17446,9.177,488787,159937,328850,4.781,14.611,468002,156911,311091,4.69,13.99,20785,0.621,27.979,10969,11217,70781
2005,37,153264,196184,3399114,3378997,22746,11.734,18084,9.329,506813,187151,319662,5.539,14.999,467891,141152,326739,4.177,13.847,38922,1.152,27.694,11657,11955,70864
2006,37,156988,202548,3520311,3460945,26381,13.256,19319,9.707,568912,223830,345082,6.467,16.438,450260,156265,293995,4.515,13.01,118652,3.428,26.019,13501,13719,77660
2007,37,159557,206825,3553959,3537845,24566,12.019,19716,9.646,546526,190838,355688,5.394,15.448,514568,161180,353388,4.556,14.545,31958,0.903,29.089,12346,12592,73387
2008,37,158612,206843,3542319,3544090,21447,10.385,20815,10.079,498976,168597,330379,4.757,14.079,503899,162113,341786,4.574,14.218,-4923,-0.139,28.158,13824,14083,78459
2009,37,152474,201094,3317922,3433320,18026,8.834,23957,11.74,366185,143276,222909,4.173,10.666,597594,170184,427410,4.957,17.406,-231409,-6.74,21.331,15592,15908,85823
2010,37,150071,198810,3217876,3263780,19190,9.612,20849,10.443,382903,145248,237655,4.45,11.732,472774,137982,334792,4.228,14.485,-89871,-2.754,23.464,12666,13023,67414
2011,37,148601,197591,3269559,3242053,18895,9.547,19543,9.874,424824,133980,290844,4.133,13.104,369505,115448,254057,3.561,11.397,55319,1.706,22.795,12321,12707,63888
2012,37,149224,198508,3328451,3294438,19281,9.752,17711,8.957,441021,127847,313174,3.881,13.387,372992,120124,252868,3.646,11.322,68029,2.065,22.644,10629,10888,60649
2013,37,149318,199170,3384432,3353460,18808,9.475,17455,8.794,439391,142894,296497,4.261,13.103,376788,123999,252789,3.698,11.236,62603,1.867,22.472,10858,11018,57201
2014,37,149740,200405,3444800,3413941,18680,9.363,16908,8.474,418813,129635,289178,3.797,12.268,358332,122272,236060,3.582,10.496,60481,1.772,20.992,10829,11069,56942
2015,37,151557,203059,3557514,3499299,19283,9.571,16101,7.992,459966,148478,311488,4.243,13.145,344368,111862,232506,3.197,9.841,115598,3.303,19.682,10105,10276,58842
2016,37,154657,207828,3669208,3612697,20395,9.938,15169,7.392,475008,152264,322744,4.215,13.148,363783,109539,254244,3.032,10.07,111225,3.079,20.139,10252,10457,66722
2017,37,157106,211131,3747135,3705175,20546,9.819,16761,8.01,483501,147916,335585,3.992,13.049,399827,131173,268654,3.54,10.791,83674,2.258,21.582,10854,11147,63980
2018,37,159343,213307,3852741,3810231,19586,9.239,16949,7.995,487947,153843,334104,4.038,12.806,403336,132058,271278,3.466,10.586,84611,2.221,21.171,12059,12486,73932
1978,38,13326,15110,156734,149663,2089,14.078,1547,10.425,33637,11155,22482,7.453,22.475,19468,8056,11412,5.383,13.008,14169,9.467,26.016,1087,1093,5016
1979,38,13947,15776,170320,164011,2232,14.496,1474,9.573,35070,14183,20887,8.648,21.383,22564,9012,13552,5.495,13.758,12506,7.625,27.515,1027,1031,5436
1980,38,13987,15932,173503,171748,1969,12.459,1713,10.839,30674,12025,18649,7.002,17.86,27148,8773,18375,5.108,15.807,3526,2.053,31.614,1245,1251,5623
1981,38,14112,16213,174492,173734,1905,11.906,1481,9.256,28275,11539,16736,6.642,16.275,26772,7089,19683,4.08,15.41,1503,0.865,30.82,1058,1072,4824
1982,38,13990,16153,177934,176030,1934,12.027,1790,11.131,31184,11729,19455,6.663,17.715,27195,8758,18437,4.975,15.449,3989,2.266,30.898,1235,1253,5844
1983,38,14304,16471,173420,174162,1995,12.344,1376,8.514,27682,11198,16484,6.43,15.894,29214,8287,20927,4.758,16.774,-1532,-0.88,31.789,970,994,5572
1984,38,14843,17072,180515,176243,2224,13.362,1369,8.225,31064,12654,18410,7.18,17.626,22592,7348,15244,4.169,12.819,8472,4.807,25.637,1000,1010,4936
1985,38,14578,16809,182569,181094,1836,10.927,1824,10.855,29713,11310,18403,6.245,16.408,27021,9892,17129,5.462,14.921,2692,1.487,29.842,1332,1358,7014
1986,38,14356,16641,179862,180467,1753,10.578,1616,9.751,26950,10978,15972,6.083,14.933,27918,8434,19484,4.673,15.47,-968,-0.536,29.867,1170,1199,5713
1987,38,14348,16630,180718,182604,1896,11.496,1621,9.829,28953,11450,17503,6.27,15.856,32110,9399,22711,5.147,17.585,-3157,-1.729,31.711,1097,1112,5717
1988,38,14665,17026,187145,184088,1905,11.336,1464,8.711,30307,12038,18269,6.539,16.463,24252,8612,15640,4.678,13.174,6055,3.289,26.348,974,988,4505
1989,38,14726,17164,191433,188829,1756,10.324,1447,8.507,29236,11738,17498,6.216,15.483,24228,8308,15920,4.4,12.831,5008,2.652,25.661,1049,1057,4732
1990,38,14746,17215,196676,193471,1662,9.72,1429,8.357,28008,8561,19447,4.425,14.477,21578,7407,14171,3.828,11.153,6430,3.324,22.306,1066,1079,4649
1991,38,14631,17276,201026,198035,1768,10.315,1496,8.728,31552,13022,18530,6.576,15.933,25617,7782,17835,3.93,12.936,5935,2.997,25.871,1061,1081,5102
1992,38,14613,17346,207300,204046,1690,9.82,1418,8.239,31293,10012,21281,4.907,15.336,24924,7837,17087,3.841,12.215,6369,3.121,24.43,940,950,4068
1993,38,14871,17606,215306,210975,1696,9.721,1377,7.893,31755,10233,21522,4.85,15.052,23241,6962,16279,3.3,11.016,8514,4.036,22.032,923,934,4265
1994,38,15143,17942,222638,219360,1689,9.504,1349,7.591,31813,10310,21503,4.7,14.503,25258,7985,17273,3.64,11.514,6555,2.988,23.029,967,990,4793
1995,38,15389,18219,231503,226437,1673,9.268,1338,7.412,35159,11596,23563,5.121,15.527,25143,9218,15925,4.071,11.104,10016,4.423,22.208,934,946,4987
1996,38,15448,18291,231947,230804,1618,8.89,1435,7.885,32222,10142,22080,4.394,13.961,29721,9733,19988,4.217,12.877,2501,1.084,25.754,990,1012,5034
1997,38,15312,18138,240968,236581,1637,9.002,1732,9.524,39076,12203,26873,5.158,16.517,30108,11517,18591,4.868,12.726,8968,3.791,25.453,1170,1200,7516
1998,38,15438,18271,251184,247238,1645,9.038,1506,8.274,37684,12406,25278,5.018,15.242,30035,11197,18838,4.529,12.148,7649,3.094,24.296,996,1028,5314
1999,38,15380,18306,251378,251722,1479,8.095,1406,7.696,31957,11748,20209,4.667,12.695,32207,9724,22483,3.863,12.795,-250,-0.099,25.391,972,991,5440
2000,38,15251,18199,255254,253622,1417,7.77,1493,8.187,32356,9177,23179,3.618,12.758,28943,9541,19402,3.762,11.412,3413,1.346,22.824,1065,1096,5969
2001,38,15180,18220,257521,255999,1525,8.379,1487,8.17,32473,12315,20158,4.811,12.685,29613,8471,21142,3.309,11.568,2860,1.117,23.135,999,1015,5391
2002,38,15039,18248,255319,257155,1663,9.123,1624,8.909,36675,16273,20402,6.328,14.262,40232,13320,26912,5.18,15.645,-3557,-1.383,28.524,993,1013,7171
2003,38,15095,18286,261080,257878,1482,8.125,1392,7.631,35255,9590,25665,3.719,13.671,28909,9188,19721,3.563,11.21,6346,2.461,22.421,844,849,4630
2004,38,15355,18559,264400,262641,1630,8.858,1314,7.141,33546,10406,23140,3.962,12.773,30261,13082,17179,4.981,11.522,3285,1.251,23.044,848,854,4532
2005,38,15557,18863,272284,268269,1745,9.331,1421,7.599,34805,10954,23851,4.083,12.974,26720,7398,19322,2.758,9.96,8085,3.014,19.92,953,964,4410
2006,38,15646,19121,281433,276803,2072,10.94,1709,9.023,39617,14186,25431,5.125,14.312,30502,10359,20143,3.742,11.019,9115,3.293,22.039,1207,1220,5828
2007,38,15796,19386,290678,285942,1865,9.703,1534,7.981,43914,14872,29042,5.201,15.358,34232,8935,25297,3.125,11.972,9682,3.386,23.943,934,960,5196
2008,38,15864,19459,297883,294032,1654,8.532,1509,7.784,40571,12392,28179,4.215,13.798,32803,9455,23348,3.216,11.156,7768,2.642,22.313,946,961,6270
2009,38,15873,19466,293823,295934,1537,7.895,1543,7.925,33278,9519,23759,3.217,11.245,37397,9858,27539,3.331,12.637,-4119,-1.392,22.49,973,986,5349
2010,38,16061,19726,296202,294925,1623,8.291,1323,6.758,34780,10334,24446,3.504,11.793,32135,8123,24012,2.754,10.896,2645,0.897,21.792,795,806,3380
2011,38,16339,20169,309924,303971,1916,9.618,1418,7.118,42349,12099,30250,3.98,13.932,30815,7459,23356,2.454,10.137,11534,3.794,20.275,888,904,4374
2012,38,17013,20962,332920,321492,2276,11.078,1444,7.028,55327,16073,39254,5,17.209,31959,9644,22315,3,9.941,23368,7.269,19.882,941,957,5547
2013,38,17387,21525,343220,337825,2272,10.711,1644,7.751,52143,18153,33990,5.373,15.435,41644,14918,26726,4.416,12.327,10499,3.108,24.654,1092,1095,7015
2014,38,17764,22123,359943,351426,2269,10.408,1622,7.441,53934,18512,35422,5.268,15.347,36660,10333,26327,2.94,10.432,17274,4.915,20.864,1132,1140,5225
2015,38,17998,22548,365425,362612,2231,9.998,1762,7.897,46443,17503,28940,4.827,12.808,40894,10146,30748,2.798,11.278,5549,1.53,22.555,1239,1261,6615
2016,38,17793,22534,347528,356714,1901,8.441,1877,8.334,34287,12340,21947,3.459,9.612,52714,10584,42130,2.967,14.778,-18427,-5.166,19.224,1362,1386,6699
2017,38,17561,22278,342716,344863,1798,8.033,2006,8.963,43238,14492,28746,4.202,12.538,47217,14320,32897,4.152,13.692,-3979,-1.154,25.075,1348,1368,6873
2018,38,17454,22149,345651,342997,1682,7.581,1761,7.937,42283,11661,30622,3.4,12.328,37248,10915,26333,3.182,10.86,5035,1.468,21.719,1291,1352,6512
1978,39,155650,192772,3588893,3495119,24569,12.914,19514,10.257,644932,200194,444738,5.728,18.452,459070,188656,270414,5.398,13.135,185862,5.318,26.269,12264,12466,63006
1979,39,158386,196543,3729644,3651301,23244,11.989,17916,9.241,600677,207074,393603,5.671,16.451,443884,170774,273110,4.677,12.157,156793,4.294,24.314,11125,11351,61212
1980,39,156963,196180,3660462,3703090,20537,10.496,19504,9.968,495368,190754,304614,5.151,13.377,583497,162244,421253,4.381,15.757,-88129,-2.38,26.754,12844,13043,68387
1981,39,157167,197078,3557904,3605764,20400,10.416,17944,9.162,439660,176697,262963,4.9,12.193,534894,146931,387963,4.075,14.834,-95234,-2.641,24.387,11248,11521,54212
1982,39,155359,196138,3500057,3526942,21705,11.089,20886,10.671,504323,222151,282172,6.299,14.299,558807,152656,406151,4.328,15.844,-54484,-1.545,28.598,13653,13948,69206
1983,39,158190,198678,3396260,3419299,21862,11.153,16558,8.447,497876,194110,303766,5.677,14.561,544103,141640,402463,4.142,15.913,-46227,-1.352,29.122,10431,10735,60301
1984,39,163251,204078,3570965,3470223,23738,11.862,15815,7.903,585468,184225,401243,5.309,16.871,382081,117908,264173,3.398,11.01,203387,5.861,22.021,10721,10960,54932
1985,39,164224,204671,3690509,3611521,22970,11.339,18765,9.264,603836,193086,410750,5.346,16.72,447565,165283,282282,4.577,12.393,156271,4.327,24.785,12835,13141,80528
1986,39,165928,207417,3767021,3712733,23811,11.649,17787,8.702,602531,217795,384736,5.866,16.229,493350,153687,339663,4.139,13.288,109181,2.941,26.576,12044,12282,72871
1987,39,168499,211959,3902282,3855536,26195,12.577,18826,9.039,676509,259086,417423,6.72,17.546,585453,207900,377553,5.392,15.185,91056,2.362,30.369,12343,12581,84990
1988,39,173412,219231,4024794,3952737,26418,12.264,18790,8.723,695226,279426,415800,7.069,17.588,552425,191437,360988,4.843,13.976,142801,3.613,27.952,12416,12874,94781
1989,39,176491,223908,4170369,4095416,25934,11.766,18960,8.602,698485,263487,434998,6.434,17.055,546585,203824,342761,4.977,13.346,151900,3.709,26.693,12850,13380,90055
1990,39,178264,227015,4278561,4231280,24164,10.769,18888,8.418,616944,213631,403313,5.049,14.581,522765,156760,366005,3.705,12.355,94179,2.226,24.71,13436,13817,91408
1991,39,177596,228506,4136566,4197087,23932,10.562,20076,8.861,541195,204083,337112,4.862,12.895,666021,200975,465046,4.788,15.869,-124826,-2.974,25.789,13945,14253,118877
1992,39,177531,228640,4142033,4130305,22382,9.841,19952,8.773,587997,199924,388073,4.84,14.236,564528,170765,393763,4.134,13.668,23469,0.568,27.336,12738,13131,90352
1993,39,180372,230525,4198863,4168801,22485,9.808,19925,8.692,605430,193916,411514,4.652,14.523,545469,175692,369777,4.214,13.085,59961,1.438,26.169,12478,12996,81393
1994,39,183558,234761,4341188,4280750,23515,10.106,19346,8.315,639811,213644,426167,4.991,14.946,518443,173122,345321,4.044,12.111,121368,2.835,24.222,12790,13207,85655
1995,39,187257,239559,4507384,4419850,24760,10.452,19427,8.201,677122,229595,447527,5.195,15.32,503244,161793,341451,3.661,11.386,173878,3.934,22.772,12963,13425,85310
1996,39,187845,241227,4536277,4504477,23790,9.93,20476,8.547,648246,224301,423945,4.98,14.391,583420,185068,398352,4.109,12.952,64826,1.439,25.904,13694,14110,92258
1997,39,188711,242562,4622279,4587244,25128,10.399,23274,9.632,727052,264615,462437,5.768,15.849,655515,225976,429539,4.926,14.29,71537,1.559,28.58,14524,15029,100257
1998,39,190385,244988,4787502,4728122,23095,9.471,20803,8.531,723293,230181,493112,4.868,15.298,604868,213557,391311,4.517,12.793,118425,2.505,25.586,13067,13540,86399
1999,39,190047,245623,4827035,4812291,21969,8.969,20619,8.418,684413,225340,459073,4.683,14.222,656708,220925,435783,4.591,13.646,27705,0.576,27.293,13154,13716,92638
2000,39,189615,246102,4967060,4911169,22106,9.001,21083,8.585,766501,250759,515742,5.106,15.607,657299,229302,427997,4.669,13.384,109202,2.224,26.768,12965,13498,89768
2001,39,188039,245566,4900456,4932995,21895,8.923,21516,8.769,651105,236793,414312,4.8,13.199,717929,205421,512508,4.164,14.554,-66824,-1.355,26.398,13153,13738,91295
2002,39,186768,245389,4725861,4821039,24279,9.894,24269,9.89,706584,268605,437979,5.572,14.656,895040,282728,612312,5.864,18.565,-188456,-3.909,29.313,13987,14552,129737
2003,39,186517,245173,4740425,4733895,22528,9.196,22158,9.045,669534,210960,458574,4.456,14.143,658534,199474,459060,4.214,13.911,11000,0.232,27.822,13003,13429,85874
2004,39,187016,246189,4722196,4730211,22312,9.089,20924,8.523,610776,196797,413979,4.16,12.912,627387,219796,407591,4.647,13.263,-16611,-0.351,25.824,12881,13412,97152
2005,39,186732,246777,4733979,4727046,22505,9.14,21426,8.701,644688,223734,420954,4.733,13.638,629737,188746,440991,3.993,13.322,14951,0.316,26.644,13612,13950,92283
2006,39,186244,248543,4796124,4764041,24841,10.045,22363,9.043,660517,234599,425918,4.924,13.865,598179,195598,402581,4.106,12.556,62338,1.309,25.112,14718,15081,89590
2007,39,183773,247436,4749019,4772249,23283,9.402,23664,9.556,629692,222508,407184,4.663,13.195,676191,218693,457498,4.583,14.169,-46499,-0.974,26.39,14328,14657,92551
2008,39,179508,242546,4701570,4724054,19674,8.04,23984,9.801,600688,196186,404502,4.153,12.716,645993,218761,427232,4.631,13.675,-45305,-0.959,25.431,14691,15049,104252
2009,39,174023,236619,4453638,4581859,17598,7.34,23859,9.952,480034,178702,301332,3.9,10.477,736986,200803,536183,4.383,16.085,-256952,-5.608,20.954,14561,15032,98613
2010,39,170312,232756,4341807,4396663,17371,7.409,20750,8.851,459152,142922,316230,3.251,10.443,568170,147473,420697,3.354,12.923,-109018,-2.48,20.886,12043,12500,74820
2011,39,168717,231111,4421263,4383991,18070,7.8,19192,8.284,540904,141205,399699,3.221,12.338,466774,142075,324699,3.241,10.647,74130,1.691,21.294,11390,11918,70521
2012,39,168788,231045,4520675,4469116,18786,8.141,18222,7.896,587671,153157,434514,3.427,13.15,482738,150241,332497,3.362,10.802,104933,2.348,21.603,10429,10836,70955
2013,39,167628,230311,4547824,4534028,18034,7.828,18164,7.885,542991,153485,389506,3.385,11.976,514923,170957,343966,3.771,11.357,28068,0.619,22.714,10710,10967,65789
2014,39,166901,231005,4607559,4578303,17918,7.775,16804,7.292,523415,158250,365165,3.457,11.433,464947,124928,340019,2.729,10.155,58468,1.277,20.311,10339,10653,62617
2015,39,166737,232575,4683805,4645855,19092,8.244,17094,7.382,560912,171112,389800,3.683,12.073,484819,139568,345251,3.004,10.436,76093,1.638,20.871,10312,10616,71023
2016,39,166882,236083,4775602,4732835,19499,8.328,15611,6.667,548810,164565,384245,3.477,11.596,464001,124355,339646,2.627,9.804,84809,1.792,19.608,10474,10823,68900
2017,39,165592,233141,4799224,4780939,17630,7.522,20090,8.572,591918,169252,422666,3.54,12.381,557206,192199,365007,4.02,11.655,34712,0.726,23.309,11064,11467,97139
2018,39,165006,232107,4866062,4832277,16383,7.05,16949,7.293,566789,156135,410654,3.231,11.729,499741,146563,353178,3.033,10.342,67048,1.388,20.683,11308,11872,77577
1978,40,52035,60324,791475,759066,10057,16.98,7864,13.278,185789,76285,109504,10.05,24.476,121345,53682,67663,7.072,15.986,64444,8.49,31.972,5679,5732,28175
1979,40,53516,62228,851092,821120,9940,16.328,7241,11.894,182017,69139,112878,8.42,22.167,121435,48822,72613,5.946,14.789,60582,7.378,29.578,5180,5222,28590
1980,40,54086,63285,882108,866470,9500,15.213,7822,12.526,178860,75358,103502,8.697,20.642,146469,54958,91511,6.343,16.904,32391,3.738,33.808,5678,5755,32270
1981,40,55854,65548,936418,907693,9959,15.527,7140,11.132,187938,73807,114131,8.131,20.705,130947,42815,88132,4.717,14.426,56991,6.279,28.853,4986,5072,24619
1982,40,57624,67757,992633,963203,11030,16.623,8227,12.398,222360,88209,134151,9.158,23.085,163528,61371,102157,6.372,16.978,58832,6.108,33.955,6024,6098,32702
1983,40,58993,69133,923304,953024,10157,14.965,7631,11.244,165560,70219,95341,7.368,17.372,225302,61088,164214,6.41,23.641,-59742,-6.269,34.744,5662,5742,36830
1984,40,60660,71139,935883,925768,11083,15.918,8056,11.57,178680,73928,104752,7.986,19.301,157883,53265,104618,5.754,17.054,20797,2.246,34.109,6204,6279,33769
1985,40,59818,70363,974339,947027,10028,14.313,9422,13.448,211374,96240,115134,10.162,22.32,157525,60605,96920,6.4,16.634,53849,5.686,33.267,7178,7245,39844
1986,40,57770,68667,948864,958132,9177,13.337,9463,13.752,160535,70662,89873,7.375,16.755,178767,64406,114361,6.722,18.658,-18232,-1.903,33.51,7089,7192,37306
1987,40,55433,66377,864034,910196,8739,13.075,9657,14.449,155285,73418,81867,8.066,17.061,248585,68682,179903,7.546,27.311,-93300,-10.251,34.121,6678,6820,38499
1988,40,55534,66985,889899,877309,8854,13.297,8058,12.101,172115,68207,103908,7.775,19.619,147525,57156,90369,6.515,16.816,24590,2.803,33.631,5723,5888,31113
1989,40,55680,67331,918873,901552,8621,12.929,7319,10.976,168156,63959,104197,7.094,18.652,133845,50798,83047,5.635,14.846,34311,3.806,29.692,5291,5401,29202
1990,40,56358,68076,937650,925777,8423,12.521,6817,10.133,157290,56732,100558,6.128,16.99,133865,46655,87210,5.04,14.46,23425,2.53,28.92,4963,5085,27383
1991,40,56816,69142,953907,942758,8731,12.806,6800,9.974,160655,67471,93184,7.157,17.041,137439,50889,86550,5.398,14.578,23216,2.463,29.157,4844,4971,31062
1992,40,57148,69673,962416,955603,8270,11.997,6793,9.854,161165,56600,104565,5.923,16.865,148257,51735,96522,5.414,15.515,12908,1.351,31.029,4706,4813,28227
1993,40,58515,70856,979779,970975,8242,11.748,6840,9.75,159933,54909,105024,5.655,16.471,142698,49537,93161,5.102,14.696,17235,1.775,29.393,4597,4680,27556
1994,40,59780,72505,1007934,994781,8667,12.098,6938,9.684,164148,59852,104296,6.017,16.501,137825,50643,87182,5.091,13.855,26323,2.646,27.71,4939,5025,29991
1995,40,60747,73720,1036905,1022004,8507,11.655,7050,9.659,166706,61291,105415,5.997,16.312,136491,51092,85399,4.999,13.355,30215,2.956,26.71,5104,5232,30031
1996,40,61172,74546,1054488,1041845,8618,11.668,7240,9.803,169845,67383,102462,6.468,16.302,145115,54379,90736,5.219,13.929,24730,2.374,27.857,5276,5386,30186
1997,40,61696,75443,1096911,1076382,9193,12.281,8021,10.715,200891,73162,127729,6.797,18.664,159453,54869,104584,5.098,14.814,41438,3.85,29.628,5515,5646,33348
1998,40,62404,76367,1150509,1130468,8547,11.258,7657,10.085,196822,67412,129410,5.963,17.411,156797,62911,93886,5.565,13.87,40025,3.541,27.74,5093,5265,32678
1999,40,62257,76578,1153681,1152642,8460,11.081,8000,10.478,187316,70068,117248,6.079,16.251,185877,69234,116643,6.007,16.126,1439,0.125,32.252,5333,5498,34620
2000,40,61984,76583,1198490,1177783,8168,10.684,7909,10.345,207191,75561,131630,6.416,17.592,166285,62037,104248,5.267,14.118,40906,3.473,28.237,5138,5304,30832
2001,40,61806,76764,1208611,1204492,8187,10.695,7765,10.143,190092,70156,119936,5.825,15.782,181894,65907,115987,5.472,15.101,8198,0.681,30.203,4991,5117,30534
2002,40,62346,77558,1187980,1199940,8898,11.535,8059,10.447,203619,80166,123453,6.681,16.969,227431,84568,142863,7.048,18.954,-23812,-1.984,33.938,4934,5090,39874
2003,40,62697,78040,1171581,1179523,8133,10.473,7373,9.494,174640,57803,116837,4.901,14.806,190599,58357,132242,4.948,16.159,-15959,-1.353,29.612,4870,4922,28737
2004,40,63476,79004,1184805,1178095,8166,10.412,7020,8.951,177493,58756,118737,4.987,15.066,164267,53767,110500,4.564,13.943,13226,1.123,27.887,4591,4703,26923
2005,40,64311,80346,1212613,1199100,8843,11.111,7333,9.213,181983,68997,112986,5.754,15.177,155430,51123,104307,4.263,12.962,26553,2.214,25.924,4976,5077,30099
2006,40,65208,81913,1276344,1244687,9930,12.261,8081,9.978,215659,84887,130772,6.82,17.326,152572,54269,98303,4.36,12.258,63087,5.069,24.516,5675,5824,30953
2007,40,65764,83140,1296272,1285945,9243,11.223,7682,9.327,210463,68744,141719,5.346,16.366,189373,58816,130557,4.574,14.726,21090,1.64,29.453,5001,5079,30150
2008,40,65920,83788,1321266,1309379,8572,10.284,7696,9.233,199066,67276,131790,5.138,15.203,175841,54801,121040,4.185,13.429,23225,1.774,26.859,5150,5277,27637
2009,40,65673,83597,1282193,1302606,7514,8.971,7845,9.366,157893,53797,104096,4.13,12.121,198554,63496,135058,4.875,15.243,-40661,-3.122,24.243,5238,5340,36792
2010,40,64939,82980,1235457,1258350,7006,8.425,7365,8.856,138414,53271,85143,4.233,11,183701,51307,132394,4.077,14.599,-45287,-3.599,21.999,4772,4841,25588
2011,40,64638,83046,1262242,1248701,7425,8.959,7094,8.559,164431,47986,116445,3.843,13.168,137420,41124,96296,3.293,11.005,27011,2.163,22.01,4753,4911,22755
2012,40,65155,83722,1293828,1278071,7766,9.33,6794,8.162,181282,57981,123301,4.537,14.184,149873,46758,103115,3.658,11.727,31409,2.458,23.453,4252,4380,23603
2013,40,65521,84232,1318611,1305586,7614,9.082,6827,8.143,175541,56957,118584,4.363,13.445,149383,50287,99096,3.852,11.442,26158,2.004,22.884,4335,4451,27099
2014,40,65874,85037,1352961,1335147,7602,8.991,6624,7.835,178784,55335,123449,4.144,13.391,143008,47202,95806,3.535,10.711,35776,2.68,21.422,4504,4569,26887
2015,40,65931,85614,1366654,1359033,7775,9.125,6960,8.168,172305,58569,113736,4.31,12.679,158396,52391,106005,3.855,11.655,13909,1.023,23.31,4725,4813,25556
2016,40,65650,86143,1356799,1361338,7900,9.209,7186,8.377,163961,57419,106542,4.218,12.044,173914,46050,127864,3.383,12.775,-9953,-0.731,24.088,5043,5134,26404
2017,40,65400,85693,1356564,1353617,7421,8.65,7625,8.887,173958,56373,117585,4.165,12.851,168113,54516,113597,4.027,12.42,5845,0.432,24.839,4907,5020,29633
2018,40,65386,85518,1382826,1369738,7158,8.372,7112,8.319,179914,52329,127585,3.82,13.135,154361,48320,106041,3.528,11.269,25553,1.866,22.539,5193,5358,27892
1978,41,50075,57750,781846,727763,10652,19.121,6569,11.792,202037,71170,130867,9.779,27.761,94562,43076,51486,5.919,12.994,107475,14.768,25.987,4670,4697,23383
1979,41,51855,59979,822329,801544,9866,16.862,6929,11.842,168866,64216,104650,8.012,21.068,126869,51854,75015,6.469,15.828,41997,5.24,31.656,4739,4799,24791
1980,41,52306,60629,833846,828869,9472,15.786,8219,13.698,157054,68914,88140,8.314,18.948,148163,52641,95522,6.351,17.875,8891,1.073,35.751,5754,5875,30845
1981,41,52748,61344,807981,818716,8716,14.377,7281,12.01,130351,55184,75167,6.74,15.921,152335,46081,106254,5.628,18.607,-21984,-2.685,31.843,4991,5078,23467
1982,41,51093,60222,767398,786419,8761,14.521,8981,14.886,126344,58788,67556,7.475,16.066,164214,46348,117866,5.894,20.881,-37870,-4.816,32.131,6406,6498,28771
1983,41,51739,60867,767851,763682,8348,13.928,6491,10.829,143100,58997,84103,7.725,18.738,135399,39374,96025,5.156,17.73,7701,1.008,35.46,4427,4546,23834
1984,41,54342,63690,812201,786499,9767,15.812,5926,9.594,160836,54993,105843,6.992,20.45,108167,32760,75407,4.165,13.753,52669,6.697,27.506,4316,4381,19688
1985,41,54941,64211,835505,820143,9361,14.786,7555,11.934,163379,62718,100661,7.647,19.921,132509,50038,82471,6.101,16.157,30870,3.764,32.314,5426,5593,29752
1986,41,55906,65363,848709,838217,9510,14.833,7009,10.932,157427,62770,94657,7.489,18.781,136068,47786,88282,5.701,16.233,21359,2.548,32.466,5041,5100,27852
1987,41,56911,66956,884224,878528,10161,15.479,7537,11.482,174286,66983,107303,7.624,19.838,161545,56303,105242,6.409,18.388,12741,1.45,36.776,5332,5385,32012
1988,41,58596,69237,932005,909086,9866,14.508,7397,10.878,189483,71466,118017,7.861,20.843,143025,58639,84386,6.45,15.733,46458,5.11,31.466,5216,5342,32832
1989,41,60131,71268,977796,952393,9896,14.178,6953,9.962,194218,69419,124799,7.289,20.393,142507,58372,84135,6.129,14.963,51711,5.43,29.926,5054,5184,29664
1990,41,61282,72684,1018823,995009,9505,13.285,7229,10.104,187036,65814,121222,6.614,18.797,139387,48891,90496,4.914,14.009,47649,4.789,28.017,5236,5366,31504
1991,41,61736,74086,1018041,1015668,10001,13.722,7595,10.421,176731,72793,103938,7.167,17.4,172120,61323,110797,6.038,16.946,4611,0.454,33.893,5387,5572,38093
1992,41,62823,75345,1037448,1024348,9463,12.754,7161,9.652,183184,66763,116421,6.518,17.883,157250,49673,107577,4.849,15.351,25934,2.532,30.702,4827,4913,28505
1993,41,64454,76812,1056956,1046253,9405,12.39,7592,10.002,178561,56486,122075,5.399,17.067,156618,51808,104810,4.952,14.969,21943,2.097,29.939,4914,4995,24580
1994,41,67341,80255,1116868,1091387,10810,13.772,7290,9.287,197034,70768,126266,6.484,18.054,145296,49259,96037,4.513,13.313,51738,4.741,26.626,5078,5186,29212
1995,41,69425,82828,1172377,1143260,10875,13.365,7954,9.775,205002,73001,132001,6.385,17.931,147511,51977,95534,4.546,12.903,57491,5.029,25.805,5604,5779,34017
1996,41,70752,84617,1212431,1187263,10703,12.834,8260,9.905,207460,71341,136119,6.009,17.474,157533,53104,104429,4.473,13.269,49927,4.205,26.537,5864,5994,33610
1997,41,71890,86050,1271074,1246802,11059,12.981,9352,10.977,236314,79295,157019,6.36,18.954,186728,68225,118503,5.472,14.977,49586,3.977,29.953,6239,6343,34404
1998,41,73083,87428,1303826,1290824,10544,12.16,9111,10.507,216667,79596,137071,6.166,16.785,189111,67383,121728,5.22,14.65,27556,2.135,29.301,5897,6006,33091
1999,41,73505,88388,1319789,1310225,10433,11.893,9100,10.374,212967,74456,138511,5.683,16.254,193733,76713,117020,5.855,14.786,19234,1.468,29.572,6121,6304,37498
2000,41,73678,88685,1342069,1333413,9930,11.239,9273,10.495,221296,83091,138205,6.231,16.596,203570,71418,132152,5.356,15.267,17726,1.329,30.534,6006,6211,33731
2001,41,73878,89540,1359939,1353070,10572,11.894,9258,10.416,217619,82847,134772,6.123,16.083,203788,61438,142350,4.541,15.061,13831,1.022,30.122,6023,6201,31927
2002,41,73545,89838,1324465,1344678,10651,11.89,10131,11.31,211685,80776,130909,6.007,15.742,252007,83428,168579,6.204,18.741,-40322,-2.999,31.485,6245,6403,45354
2003,41,74896,91307,1329363,1325108,10722,11.862,8887,9.832,204247,62244,142003,4.697,15.414,196466,67820,128646,5.118,14.826,7781,0.587,29.653,5479,5574,28640
2004,41,76235,92952,1346986,1338512,10591,11.512,8681,9.436,189333,65572,123761,4.899,14.145,172525,63173,109352,4.72,12.889,16808,1.256,25.779,5608,5708,30878
2005,41,78744,95865,1398846,1373757,11962,12.686,8819,9.353,213039,77105,135934,5.613,15.508,162510,54929,107581,3.998,11.83,50529,3.678,23.659,5679,5831,29056
2006,41,81130,99246,1455359,1426797,13582,13.95,9820,10.086,231102,87012,144090,6.098,16.197,174424,55667,118757,3.902,12.225,56678,3.972,24.45,7155,7210,35411
2007,41,82668,101435,1477260,1468883,12076,12.062,9431,9.42,216370,71993,144377,4.901,14.73,199036,61062,137974,4.157,13.55,17334,1.18,27.1,6166,6267,31040
2008,41,82135,101152,1475348,1475520,10598,10.482,10506,10.391,198177,61163,137014,4.145,13.431,198621,60912,137709,4.128,13.461,-444,-0.03,26.862,7020,7133,32956
2009,41,78708,97799,1362481,1416986,8803,8.852,12095,12.163,153245,56774,96471,4.007,10.815,261371,67353,194018,4.753,18.446,-108126,-7.631,21.63,7891,8014,39294
2010,41,77467,96809,1322998,1336991,9521,9.803,10156,10.456,152591,53083,99508,3.97,11.413,179992,51286,128706,3.836,13.462,-27401,-2.049,22.826,6301,6439,27405
2011,41,77060,96512,1339134,1330990,9447,9.79,9414,9.756,166997,46435,120562,3.489,12.547,150876,48824,102052,3.668,11.336,16121,1.211,22.671,5957,6155,25831
2012,41,77586,96848,1365669,1351680,9583,9.931,8877,9.199,177246,52799,124447,3.906,13.113,149372,45041,104331,3.332,11.051,27874,2.062,22.102,5181,5271,23430
2013,41,78384,97863,1391506,1374634,9744,10.028,8356,8.599,177647,49320,128327,3.588,12.923,144286,46810,97476,3.405,10.496,33361,2.427,20.993,5137,5221,23863
2014,41,79418,99411,1434072,1412546,9856,10.006,8038,8.16,185236,56065,129171,3.969,13.114,142637,42354,100283,2.998,10.098,42599,3.016,20.196,5250,5321,22588
2015,41,80993,101675,1495227,1465098,10282,10.241,7739,7.708,203140,63348,139792,4.324,13.865,142836,44785,98051,3.057,9.749,60304,4.116,19.498,5060,5121,24928
2016,41,82776,104019,1547169,1521368,10563,10.283,7970,7.759,195988,59522,136466,3.912,12.882,145302,46138,99164,3.033,9.551,50686,3.332,19.101,5401,5499,25957
2017,41,83824,105504,1592436,1568705,10481,10.02,8675,8.293,217368,61209,156159,3.902,13.857,169958,52720,117238,3.361,10.834,47410,3.022,21.669,5916,6009,27729
2018,41,85235,106812,1629243,1611137,10214,9.634,8640,8.149,200690,58018,142672,3.601,12.456,165748,53333,112415,3.31,10.288,34942,2.169,20.575,6429,6555,32462
1978,42,177656,211727,3821400,3751970,25591,12.215,21148,10.094,688630,224170,464460,5.975,18.354,552381,246063,306318,6.558,14.722,136249,3.631,29.445,13480,13732,106309
1979,42,181634,216966,3953110,3869635,24469,11.448,18022,8.432,635588,205446,430142,5.309,16.425,469472,161386,308086,4.171,12.132,166116,4.293,24.264,12164,12347,63461
1980,42,179229,214915,3951357,3951598,21298,9.892,22057,10.245,550424,203421,347003,5.148,13.929,549776,184666,365110,4.673,13.913,648,0.016,27.826,14534,14754,77531
1981,42,177722,214611,3908549,3924989,20419,9.541,19242,8.991,503154,195416,307738,4.979,12.819,538876,146224,392652,3.725,13.729,-35722,-0.91,25.638,12450,12718,62672
1982,42,175993,214545,3927429,3914479,22756,10.646,21181,9.909,597153,259464,337689,6.628,15.255,569431,163062,406369,4.166,14.547,27722,0.708,29.094,14157,14461,75090
1983,42,180112,218644,3812646,3843021,23910,11.11,17057,7.925,558394,210231,348163,5.47,14.53,621322,160449,460873,4.175,16.168,-62928,-1.637,29.06,11000,11303,66766
1984,42,184384,223489,3992854,3893427,25729,11.708,18278,8.317,657105,229766,427339,5.901,16.877,454913,136490,318423,3.506,11.684,202192,5.193,23.368,12375,12605,66186
1985,42,186031,225263,4062896,4010534,26467,11.885,21314,9.571,636308,220782,415526,5.505,15.866,531738,192162,339576,4.791,13.259,104570,2.607,26.517,14453,14814,100137
1986,42,190419,230569,4133855,4077513,27983,12.365,19459,8.598,673413,252323,421090,6.188,16.515,559326,170882,388444,4.191,13.717,114087,2.798,27.435,13307,13603,82267
1987,42,194764,236616,4258907,4191685,29632,12.761,20808,8.961,726391,269246,457145,6.423,17.329,591831,205476,386355,4.902,14.119,134560,3.21,28.238,13986,14241,95934
1988,42,201490,245667,4378355,4317319,30028,12.46,20692,8.586,728862,265726,463136,6.155,16.882,607385,208609,398776,4.832,14.069,121477,2.814,28.137,14357,14720,111006
1989,42,206026,251751,4498956,4431444,29125,11.762,20878,8.431,706014,245702,460312,5.545,15.932,571688,201603,370085,4.549,12.901,134326,3.031,25.801,14670,15096,100491
1990,42,209364,256488,4603005,4548670,27632,10.918,20843,8.235,660050,213128,446922,4.686,14.511,550844,158659,392185,3.488,12.11,109206,2.401,24.22,15133,15520,95191
1991,42,207718,256992,4504113,4540075,26164,10.243,23043,9.021,605169,227228,377941,5.005,13.329,677515,211669,465846,4.662,14.923,-72346,-1.593,26.659,16363,16862,126867
1992,42,205910,255561,4499188,4503357,24025,9.422,22863,8.967,640986,224845,416141,4.993,14.234,651975,180577,471398,4.01,14.478,-10989,-0.244,28.467,15235,15626,92551
1993,42,206305,255274,4518396,4507598,23208,9.099,22804,8.94,628499,204444,424055,4.536,13.943,607777,189939,417838,4.214,13.483,20722,0.46,26.967,14929,15353,91097
1994,42,206275,256530,4548657,4541395,23700,9.264,22315,8.722,634262,218138,416124,4.803,13.966,618475,225140,393335,4.958,13.619,15787,0.348,27.237,15213,15606,123439
1995,42,209259,260616,4668569,4606755,25744,9.968,21030,8.143,659250,233759,425491,5.074,14.311,535263,192573,342690,4.18,11.619,123987,2.691,23.238,14291,14810,109109
1996,42,208807,261208,4647715,4630009,24673,9.488,22360,8.598,626587,225653,400934,4.874,13.533,592887,200377,392510,4.328,12.805,33700,0.728,25.611,15190,15640,98443
1997,42,210156,263558,4757754,4706455,26876,10.254,23969,9.145,750152,264965,485187,5.63,15.939,647795,236611,411184,5.027,13.764,102357,2.175,27.528,15332,15921,119884
1998,42,212283,266420,4883682,4839637,24840,9.372,22073,8.328,708497,228445,480052,4.72,14.639,619251,209599,409652,4.331,12.795,89246,1.844,25.591,13800,14260,89003
1999,42,212310,267183,4936634,4909852,23983,9.003,22398,8.408,694809,241511,453298,4.919,14.151,642026,214676,427350,4.372,13.076,52783,1.075,26.153,14342,14798,94094
2000,42,212836,268587,5053648,4995545,24069,8.992,22221,8.302,749032,258553,490479,5.176,14.994,633915,221973,411942,4.443,12.69,115117,2.304,25.379,13838,14394,88136
2001,42,212418,269621,5066943,5057445,24900,9.268,22969,8.55,705660,259709,445951,5.135,13.953,684127,227545,456582,4.499,13.527,21533,0.426,27.054,14054,14696,100590
2002,42,212076,270490,5005728,5054207,26537,9.83,25488,9.441,753612,292389,461223,5.785,14.911,851130,306451,544679,6.063,16.84,-97518,-1.929,29.821,14856,15500,133510
2003,42,212612,271489,4978901,4983843,24949,9.217,23358,8.629,691378,221883,469495,4.452,13.872,701957,215704,486253,4.328,14.085,-10579,-0.212,27.745,14005,14456,91527
2004,42,215028,274046,5042077,5012015,25156,9.229,22195,8.143,670376,204800,465576,4.086,13.375,611954,201767,410187,4.026,12.21,58422,1.166,24.419,13813,14116,84843
2005,42,216422,276565,5064514,5063334,26501,9.636,23413,8.513,642759,231805,410954,4.578,12.694,639850,190617,449233,3.765,12.637,2909,0.057,25.274,14924,15291,85784
2006,42,216702,279813,5178662,5121671,28084,10.112,23914,8.611,689122,246827,442295,4.819,13.455,575816,178976,396840,3.494,11.243,113306,2.212,22.485,16123,16571,91932
2007,42,216089,279787,5177025,5177329,26080,9.335,25268,9.044,683371,225340,458031,4.352,13.199,682197,223039,459158,4.308,13.177,1174,0.023,26.353,14912,15239,88680
2008,42,214096,278931,5202397,5186930,23867,8.553,24131,8.647,660180,196765,463415,3.793,12.728,632868,195068,437800,3.761,12.201,27312,0.527,24.402,15203,15525,83371
2009,42,211081,275969,5019744,5113427,21463,7.73,24845,8.948,524770,177950,346820,3.48,10.263,713495,209158,504337,4.09,13.953,-188725,-3.691,20.525,14984,15393,105431
2010,42,208159,273451,4956134,4987351,21049,7.669,23060,8.402,541310,179787,361523,3.605,10.854,604089,166050,438039,3.329,12.112,-62779,-1.259,21.707,13795,14165,75823
2011,42,207427,273828,5057182,5008678,22093,8.082,21167,7.743,613362,183418,429944,3.662,12.246,515862,151104,364758,3.017,10.299,97500,1.947,20.599,12849,13195,66609
2012,42,208322,274313,5142957,5098356,22073,8.063,20976,7.662,627055,170006,457049,3.335,12.299,536695,163798,372897,3.213,10.527,90360,1.772,21.054,12144,12550,74836
2013,42,207688,274924,5157705,5150353,22291,8.125,21158,7.712,588280,180751,407529,3.509,11.422,574574,168037,406537,3.263,11.156,13706,0.266,22.312,12689,12871,86009
2014,42,207256,275382,5229190,5192909,21904,7.969,20879,7.596,578991,179070,399921,3.448,11.15,508394,154998,353396,2.985,9.79,70597,1.359,19.58,12826,13143,75430
2015,42,207064,276266,5290851,5260089,22395,8.127,21022,7.628,607361,206364,400997,3.923,11.547,544709,164429,380280,3.126,10.356,62652,1.191,20.711,12771,13139,74041
2016,42,208431,279717,5344566,5316518,23378,8.419,19287,6.946,599484,187929,411555,3.535,11.276,542762,161497,381265,3.038,10.209,56722,1.067,20.418,12751,13086,77058
2017,42,207581,278690,5413365,5374014,21549,7.727,21959,7.874,645891,179074,466817,3.332,12.019,567831,170812,397019,3.178,10.566,78060,1.453,21.132,13685,13977,74542
2018,42,207438,279211,5472914,5444444,21171,7.597,20088,7.209,599250,166305,432945,3.055,11.007,541194,156369,384825,2.872,9.94,58056,1.066,19.881,13964,14348,78641
1978,44,18069,20043,321422,311398,2477,12.52,1961,9.912,60587,19161,41426,6.153,19.456,40565,18074,22491,5.804,13.027,20022,6.43,26.054,1372,1379,8108
1979,44,18628,20653,338559,330355,2403,11.843,1678,8.27,58607,19324,39283,5.849,17.741,42007,15262,26745,4.62,12.716,16600,5.025,25.431,1154,1168,6640
1980,44,18317,20407,338273,338968,2130,10.42,2200,10.762,47697,16320,31377,4.815,14.071,49395,13568,35827,4.003,14.572,-1698,-0.501,28.142,1446,1456,6508
1981,44,18561,20701,336236,336455,2179,10.635,1753,8.556,48139,17932,30207,5.33,14.308,48334,13300,35034,3.953,14.366,-195,-0.058,28.615,1093,1101,6060
1982,44,18364,20516,331822,333887,2098,10.206,2180,10.605,47211,17361,29850,5.2,14.14,51135,15011,36124,4.496,15.315,-3924,-1.175,28.28,1502,1520,8438
1983,44,18578,20683,330151,329431,2192,10.727,1693,8.285,45419,12289,33130,3.73,13.787,43849,12380,31469,3.758,13.311,1570,0.477,26.621,1177,1185,6316
1984,44,19292,21389,354178,341850,2555,12.2,1661,7.931,61436,18652,42784,5.456,17.972,36894,11948,24946,3.495,10.792,24542,7.179,21.585,1181,1208,6457
1985,44,19715,21909,364684,359189,2763,12.84,1984,9.22,60803,22220,38583,6.186,16.928,49386,17461,31925,4.861,13.749,11417,3.179,27.499,1473,1491,10511
1986,44,20319,22507,375032,366900,2910,13.205,1970,8.94,60127,20201,39926,5.506,16.388,44000,16156,27844,4.403,11.992,16127,4.395,23.985,1401,1410,8213
1987,44,21083,23440,392814,395342,3344,14.631,2174,9.512,69081,26236,42845,6.636,17.474,75572,19230,56342,4.864,19.116,-6491,-1.642,34.948,1597,1624,11701
1988,44,21968,24401,403724,399133,3382,14.154,2370,9.918,68593,25710,42883,6.441,17.186,58859,20692,38167,5.184,14.747,9734,2.439,29.493,1701,1716,10336
1989,44,22400,25017,403269,401627,3302,13.422,2471,10.044,64946,25644,39302,6.385,16.171,61713,22284,39429,5.548,15.366,3233,0.805,30.732,1932,1949,13221
1990,44,22171,24840,391756,396727,2751,11.088,2692,10.85,53395,21786,31609,5.491,13.459,63802,18809,44993,4.741,16.082,-10407,-2.623,26.918,2084,2100,11579
1991,44,21264,23982,368736,381465,2444,10.067,3034,12.497,50685,22327,28358,5.853,13.287,76409,26274,50135,6.888,20.03,-25724,-6.743,26.574,2169,2203,14839
1992,44,20812,23490,358175,361638,2419,10.251,2635,11.166,50661,17851,32810,4.936,14.009,57633,19953,37680,5.517,15.937,-6972,-1.928,28.018,1759,1791,11263
1993,44,21168,23863,367676,362305,2650,11.203,2232,9.436,55516,18839,36677,5.2,15.323,44962,14798,30164,4.084,12.41,10554,2.913,24.82,1510,1543,8306
1994,44,21507,24215,370203,369507,2702,11.242,2343,9.748,56313,23919,32394,6.473,15.24,54590,20573,34017,5.568,14.774,1723,0.466,29.547,1651,1689,10103
1995,44,21720,24517,371546,367433,2625,10.784,2274,9.342,53122,18465,34657,5.025,14.458,44921,14307,30614,3.894,12.226,8201,2.232,24.451,1602,1623,7627
1996,44,21785,24614,368803,368943,2588,10.565,2354,9.609,48428,15978,32450,4.331,13.126,48916,16759,32157,4.542,13.258,-488,-0.132,26.252,1661,1671,8777
1997,44,22025,24836,384909,380399,2642,10.693,2386,9.657,59583,19997,39586,5.257,15.663,50719,16989,33730,4.466,13.333,8864,2.33,26.666,1685,1705,9645
1998,44,22350,25153,402454,395390,2488,9.951,2186,8.743,60169,20134,40035,5.092,15.218,45612,12791,32821,3.235,11.536,14557,3.682,23.072,1477,1490,6228
1999,44,22251,25189,409687,407915,2387,9.495,2290,9.109,55764,16937,38827,4.152,13.67,52378,15778,36600,3.868,12.84,3386,0.83,25.681,1610,1624,7657
2000,44,22341,25385,417107,414303,2457,9.723,2229,8.82,62061,20617,41444,4.976,14.98,56560,22606,33954,5.456,13.652,5501,1.328,27.304,1484,1523,8112
2001,44,22318,25419,413602,414775,2391,9.43,2265,8.933,52516,17502,35014,4.22,12.661,54215,15053,39162,3.629,13.071,-1699,-0.41,25.323,1475,1515,8545
2002,44,22218,25528,417112,415757,2648,10.409,2469,9.706,65315,27527,37788,6.621,15.71,61977,18935,43042,4.554,14.907,3338,0.803,29.814,1554,1570,9614
2003,44,22456,25747,420550,418547,2660,10.386,2391,9.335,58825,18052,40773,4.313,14.055,54383,17016,37367,4.065,12.993,4442,1.061,25.987,1420,1465,7524
2004,44,23066,26478,434550,428311,2895,11.092,2141,8.203,61623,19111,42512,4.462,14.387,49452,15513,33939,3.622,11.546,12171,2.842,23.092,1447,1454,7862
2005,44,23193,26722,439997,437792,2750,10.345,2470,9.292,53469,19781,33688,4.518,12.213,48998,14851,34147,3.392,11.192,4471,1.021,22.384,1629,1637,8823
2006,44,23506,27243,439732,439764,3099,11.497,2523,9.36,61039,22783,38256,5.181,13.88,61159,16895,44264,3.842,13.907,-120,-0.027,27.76,1712,1751,8714
2007,44,23290,27198,442425,439831,2720,10.003,2706,9.952,61617,21957,39660,4.992,14.009,57074,17822,39252,4.052,12.976,4543,1.033,25.953,1819,1837,10924
2008,44,22785,26670,429570,435666,2388,8.873,2877,10.689,49570,15427,34143,3.541,11.378,62141,18975,43166,4.355,14.263,-12571,-2.885,22.756,1859,1879,8851
2009,44,21816,25605,409217,418751,2020,7.724,3117,11.918,42949,12890,30059,3.078,10.256,62020,16839,45181,4.021,14.811,-19071,-4.554,20.513,1942,1970,9605
2010,44,21419,25314,395039,402869,2279,8.959,2528,9.938,42506,16602,25904,4.121,10.551,58071,16305,41766,4.047,14.414,-15565,-3.864,21.102,1587,1596,7382
2011,44,21187,25182,403602,399393,2269,8.994,2362,9.362,49200,15204,33996,3.807,12.319,40408,13854,26554,3.469,10.117,8792,2.201,20.235,1456,1479,6391
2012,44,21228,25196,404022,403891,2314,9.195,2254,8.957,46101,13176,32925,3.262,11.414,46114,12995,33119,3.217,11.417,-13,-0.003,22.828,1352,1370,6460
2013,44,21078,25095,407841,405786,2156,8.583,2206,8.782,44788,12162,32626,2.997,11.037,40356,12311,28045,3.034,9.945,4432,1.092,19.89,1372,1385,6887
2014,44,20990,25167,420102,413798,2198,8.753,2089,8.319,51196,17711,33485,4.28,12.372,38485,11779,26706,2.847,9.3,12711,3.072,18.601,1350,1360,6707
2015,44,21181,25384,423869,421619,2293,9.078,2040,8.077,46217,13531,32686,3.209,10.962,41486,11757,29729,2.789,9.84,4731,1.122,19.679,1252,1273,7295
2016,44,21512,25956,432435,427924,2547,9.926,1954,7.615,49889,16815,33074,3.929,11.658,41184,11056,30128,2.584,9.624,8705,2.034,19.248,1335,1350,6876
2017,44,21551,25926,435908,433924,2067,7.973,2068,7.976,50729,13164,37565,3.034,11.691,46996,15486,31510,3.569,10.83,3733,0.86,21.661,1337,1356,8486
2018,44,21507,25765,442570,438948,2077,8.051,2146,8.318,54242,14729,39513,3.356,12.357,46479,16671,29808,3.798,10.589,7763,1.769,21.177,1458,1503,8123
1978,45,44522,52471,911823,878370,8324,16.228,5972,11.642,175206,66311,108895,7.549,19.947,109082,46899,62183,5.339,12.419,66124,7.528,24.837,3936,3983,16558
1979,45,45418,53925,958737,937566,7627,14.388,5793,10.929,158387,55485,102902,5.918,16.893,115835,41154,74681,4.389,12.355,42552,4.539,24.71,3883,3950,19133
1980,45,45544,54608,949872,943709,7211,13.334,6152,11.376,142344,54656,87688,5.792,15.083,129763,38477,91286,4.077,13.75,12581,1.333,27.501,4384,4480,19661
1981,45,46088,55627,958590,953375,7058,12.853,5634,10.259,144192,59922,84270,6.285,15.124,133550,37142,96408,3.896,14.008,10642,1.116,28.016,3727,3800,17025
1982,45,45731,55695,948177,951932,7179,12.948,6680,12.048,145171,60735,84436,6.38,15.25,153420,41934,111486,4.405,16.117,-8249,-0.867,30.5,4711,4763,22947
1983,45,46743,56928,941486,941508,7709,13.785,5699,10.191,151003,61810,89193,6.565,16.038,151388,43142,108246,4.582,16.079,-385,-0.041,32.077,4023,4080,20973
1984,45,50161,60727,1007620,973940,10064,17.139,6050,10.303,183352,65887,117465,6.765,18.826,115295,43977,71318,4.515,11.838,68057,6.988,23.676,4598,4642,25166
1985,45,51726,62599,1067329,1046519,8898,14.531,6171,10.077,185450,67016,118434,6.404,17.721,143126,49213,93913,4.703,13.676,42324,4.044,27.353,4440,4504,26421
1986,45,52962,64222,1073252,1055780,8929,14.196,6281,9.986,194685,77872,116813,7.376,18.44,159041,57722,101319,5.467,15.064,35644,3.376,30.128,4330,4413,26038
1987,45,54458,66514,1131145,1103744,9743,14.995,6668,10.262,225595,101707,123888,9.215,20.439,171411,66116,105295,5.99,15.53,54184,4.909,31.06,4525,4603,27279
1988,45,56653,69562,1192459,1169876,9960,14.659,6724,9.896,237929,99884,138045,8.538,20.338,192225,91211,101014,7.797,16.431,45704,3.907,32.862,4739,4842,30312
1989,45,57990,71397,1236348,1209417,9543,13.63,6780,9.684,212967,79666,133301,6.587,17.609,159308,55241,104067,4.568,13.172,53659,4.437,26.345,4819,4908,28805
1990,45,59373,73227,1281561,1254272,9603,13.345,7065,9.818,217044,83392,133652,6.649,17.304,162098,55204,106894,4.401,12.924,54946,4.381,25.847,5142,5284,31982
1991,45,59460,74346,1259040,1270889,9698,13.217,7752,10.565,191840,83932,107908,6.604,15.095,215674,66231,149443,5.211,16.97,-23834,-1.875,30.19,5425,5608,39647
1992,45,59667,74634,1277290,1265231,8740,11.804,7557,10.206,203221,77161,126060,6.099,16.062,178215,54068,124147,4.273,14.086,25006,1.976,28.171,5084,5176,30354
1993,45,61003,76061,1309700,1293165,8953,11.901,7290,9.69,197895,68018,129877,5.26,15.303,165441,55119,110322,4.262,12.793,32454,2.51,25.587,4854,4961,26168
1994,45,62384,77868,1352479,1331369,9342,12.149,7400,9.623,214579,81715,132864,6.138,16.117,172611,64176,108435,4.82,12.965,41968,3.152,25.93,5053,5173,34232
1995,45,64135,80061,1398038,1374760,9970,12.651,7458,9.464,217376,80116,137260,5.828,15.812,169539,61979,107560,4.508,12.332,47837,3.48,24.665,5205,5382,35358
1996,45,65273,81716,1416760,1403721,10114,12.545,7927,9.832,216450,81752,134698,5.824,15.42,189796,60922,128874,4.34,13.521,26654,1.899,27.042,5487,5646,34198
1997,45,66654,83690,1454663,1435866,10761,13.033,8516,10.314,246134,94685,151449,6.594,17.142,208028,76873,131155,5.354,14.488,38106,2.654,28.976,5673,5813,41755
1998,45,68206,85713,1533423,1502386,10311,12.177,8232,9.722,262147,89626,172521,5.966,17.449,200302,71094,129208,4.732,13.332,61845,4.116,26.665,5306,5415,31944
1999,45,69402,87361,1564197,1547036,10305,11.932,8316,9.629,246360,87858,158502,5.679,15.925,213782,72588,141194,4.692,13.819,32578,2.106,27.638,5391,5654,34743
2000,45,69697,88017,1608354,1591852,9707,11.094,8669,9.908,256426,86916,169510,5.46,16.109,224659,77720,146939,4.882,14.113,31767,1.996,28.226,5520,5718,37183
2001,45,69532,88265,1599311,1603745,9755,11.092,9116,10.366,240778,88881,151897,5.542,15.013,248695,83618,165077,5.214,15.507,-7917,-0.494,30.027,5793,6030,39541
2002,45,69864,89044,1537163,1574083,10365,11.703,9411,10.626,227301,87466,139835,5.557,14.44,301517,97668,203849,6.205,19.155,-74216,-4.715,28.88,5794,5970,51190
2003,45,70856,90235,1546292,1540960,10042,11.219,8591,9.598,238051,91592,146459,5.944,15.448,228217,79705,148512,5.172,14.81,9834,0.638,29.62,5444,5530,35902
2004,45,72166,91907,1564095,1557628,10095,11.098,8203,9.018,223535,78048,145487,5.011,14.351,211730,68772,142958,4.415,13.593,11805,0.758,27.186,5326,5429,33977
2005,45,73843,94230,1591171,1579218,11018,11.852,8487,9.129,234381,86701,147680,5.49,14.842,210387,62732,147655,3.972,13.322,23994,1.519,26.644,5678,5787,34218
2006,45,75546,96988,1647868,1619350,12284,12.87,9201,9.64,263537,101281,162256,6.254,16.274,207207,68159,139048,4.209,12.796,56330,3.479,25.591,6520,6673,36909
2007,45,76490,98928,1658831,1653342,11554,11.818,9234,9.445,251734,87212,164522,5.275,15.226,242125,77214,164911,4.67,14.645,9609,0.581,29.289,6063,6211,38625
2008,45,75605,98463,1658929,1657957,9730,9.872,9933,10.078,232619,72443,160176,4.369,14.03,229328,71048,158280,4.285,13.832,3291,0.198,27.664,6662,6772,36199
2009,45,72832,95730,1544401,1599454,8679,8.94,11375,11.717,174510,72735,101775,4.547,10.911,285059,76841,208218,4.804,17.822,-110549,-6.912,21.821,7412,7693,42526
2010,45,71284,94278,1502111,1526278,8484,8.944,9635,10.158,174927,66681,108246,4.369,11.461,222592,60399,162193,3.957,14.584,-47665,-3.123,22.922,6127,6307,32550
2011,45,70171,93372,1528455,1514698,8400,8.969,8978,9.586,204830,63194,141636,4.172,13.523,176864,53333,123531,3.521,11.677,27966,1.846,23.353,5799,5979,30763
2012,45,70237,93322,1554592,1538518,8245,8.849,7941,8.523,203915,56914,147001,3.699,13.254,171938,49745,122193,3.233,11.176,31977,2.078,22.351,4778,4914,23833
2013,45,70452,93556,1580360,1566802,8307,8.907,7731,8.289,193897,58276,135621,3.719,12.375,166372,49943,116429,3.188,10.619,27525,1.757,21.237,4825,4938,24317
2014,45,70750,94321,1611540,1589460,8604,9.17,7609,8.11,201419,63261,138158,3.98,12.672,157234,48239,108995,3.035,9.892,44185,2.78,19.785,4932,5027,25089
2015,45,71684,95774,1663319,1638302,9115,9.605,7369,7.765,211976,71070,140906,4.338,12.939,162654,50902,111752,3.107,9.928,49322,3.011,19.856,4803,4898,27061
2016,45,73031,98126,1719274,1691797,9458,9.767,6882,7.107,225237,76385,148852,4.515,13.313,170439,50302,120137,2.973,10.074,54798,3.239,20.149,4708,4842,27324
2017,45,73981,99396,1745842,1729132,9083,9.211,7522,7.628,227127,68281,158846,3.949,13.135,193714,64448,129266,3.727,11.203,33413,1.932,22.406,4824,4936,32923
2018,45,75156,100519,1801532,1778704,9027,9.041,7676,7.688,240414,72923,167491,4.1,13.516,195515,60180,135335,3.383,10.992,44899,2.524,21.984,5388,5601,31385
1978,46,14246,15992,169622,161080,2317,14.777,1693,10.797,38495,13462,25033,8.357,23.898,21577,8090,13487,5.022,13.395,16918,10.503,26.79,1177,1184,4575
1979,46,14794,16651,179733,174809,2241,13.762,1508,9.26,33500,13125,20375,7.508,19.164,23711,8590,15121,4.914,13.564,9789,5.6,27.128,1083,1087,5042
1980,46,14703,16607,177413,178358,1899,11.457,1836,11.077,29154,11886,17268,6.664,16.346,31151,11748,19403,6.587,17.465,-1997,-1.12,32.692,1272,1280,5587
1981,46,14579,16563,173323,175110,1733,10.496,1629,9.866,24239,9713,14526,5.547,13.842,27825,8737,19088,4.989,15.89,-3586,-2.048,27.684,1148,1158,4779
1982,46,14236,16209,172281,173016,1815,11.151,1951,11.986,26915,11691,15224,6.757,15.556,28417,8862,19555,5.122,16.425,-1502,-0.868,31.113,1348,1366,5511
1983,46,14515,16487,171182,170759,1900,11.712,1370,8.445,26008,9713,16295,5.688,15.231,25039,7020,18019,4.111,14.663,969,0.567,29.327,934,952,4443
1984,46,15043,17057,180532,174868,2209,13.274,1379,8.286,32036,11444,20592,6.544,18.32,20885,7532,13353,4.307,11.943,11151,6.377,23.887,998,1009,3937
1985,46,15024,17044,188304,184035,1978,11.7,1703,10.073,32445,13728,18717,7.459,17.63,23901,7996,15905,4.345,12.987,8544,4.643,25.974,1225,1252,5636
1986,46,14919,16955,185970,186521,1807,10.727,1587,9.421,27887,10786,17101,5.783,14.951,29069,8656,20413,4.641,15.585,-1182,-0.634,29.902,1108,1115,5289
1987,46,15008,17057,192677,188067,2003,11.905,1539,9.147,34133,14469,19664,7.694,18.149,25115,7993,17122,4.25,13.354,9018,4.795,26.709,1090,1095,4854
1988,46,15322,17494,200774,196946,1974,11.445,1481,8.587,33967,13563,20404,6.887,17.247,26060,9253,16807,4.698,13.232,7907,4.015,26.464,1042,1067,5018
1989,46,15526,17809,208299,203801,1945,11.079,1437,8.186,33330,9660,23670,4.74,16.354,24338,9240,15098,4.534,11.942,8992,4.412,23.884,1055,1068,5044
1990,46,15941,18292,219516,213259,2134,11.884,1463,8.147,36866,13839,23027,6.489,17.287,24542,9440,15102,4.427,11.508,12324,5.779,23.016,1070,1085,4560
1991,46,16101,18720,226612,222107,2136,11.607,1501,8.157,37341,13993,23348,6.3,16.812,28424,9308,19116,4.191,12.797,8917,4.015,25.595,1097,1109,6043
1992,46,16229,18927,238360,232360,2007,10.72,1598,8.535,40117,13226,26891,5.692,17.265,28144,8888,19256,3.825,12.112,11973,5.153,24.225,1069,1080,5339
1993,46,16582,19219,248907,243330,1938,10.18,1573,8.263,38594,12132,26462,4.986,15.861,27737,9233,18504,3.794,11.399,10857,4.462,22.798,1036,1056,5131
1994,46,17069,19831,258524,253911,2163,11.078,1553,7.953,38412,12937,25475,5.095,15.128,29256,9922,19334,3.908,11.522,9156,3.606,23.044,1105,1126,5726
1995,46,17421,20271,270948,264636,2070,10.339,1572,7.851,39159,12249,26910,4.629,14.797,26506,9750,16756,3.684,10.016,12653,4.781,20.032,1131,1153,5457
1996,46,17582,20504,273328,271026,2146,10.571,1739,8.566,37949,15776,22173,5.821,14.002,33219,10879,22340,4.014,12.257,4730,1.745,24.514,1257,1291,6468
1997,46,17645,20650,279648,276448,2223,10.825,1993,9.705,42382,15513,26869,5.612,15.331,36154,12087,24067,4.372,13.078,6228,2.253,26.156,1310,1353,6908
1998,46,17893,20934,292046,287090,2132,10.251,1860,8.943,41949,12283,29666,4.278,14.612,32134,11447,20687,3.987,11.193,9815,3.419,22.386,1286,1323,6270
1999,46,17955,21103,297659,294671,2085,9.931,1868,8.898,39958,14744,25214,5.004,13.56,34023,11229,22794,3.811,11.546,5935,2.014,23.092,1308,1346,6276
2000,46,18044,21226,307665,303212,1990,9.412,1824,8.627,47181,14993,32188,4.945,15.56,38065,12660,25405,4.175,12.554,9116,3.006,25.108,1228,1273,5954
2001,46,18064,21347,313436,310610,2047,9.625,1889,8.882,45280,21243,24037,6.839,14.578,40402,13165,27237,4.238,13.007,4878,1.57,26.015,1230,1253,6411
2002,46,18287,21757,300408,306779,2409,11.187,1964,9.12,43370,16403,26967,5.347,14.137,55871,18809,37062,6.131,18.212,-12501,-4.075,28.274,1274,1294,9206
2003,46,18425,21826,302357,301453,2109,9.695,1964,9.028,41048,12485,28563,4.142,13.617,39147,13912,25235,4.615,12.986,1901,0.631,25.972,1186,1204,6285
2004,46,18732,22186,309963,305687,2186,9.947,1766,8.036,44717,13620,31097,4.456,14.628,36067,12986,23081,4.248,11.799,8650,2.83,23.597,1137,1144,4944
2005,46,19096,22593,316006,312970,2270,10.144,1839,8.218,40735,11446,29289,3.657,13.016,34883,10549,24334,3.371,11.146,5852,1.87,22.292,1194,1213,5449
2006,46,19292,22915,329054,322402,2706,11.924,2265,9.98,46848,17105,29743,5.305,14.531,33546,11452,22094,3.552,10.405,13302,4.126,20.81,1655,1683,7857
2007,46,19425,23188,330594,329099,2340,10.176,1954,8.497,44206,14456,29750,4.393,13.432,41297,12421,28876,3.774,12.549,2909,0.884,25.097,1269,1280,6363
2008,46,19327,23198,337499,333813,2123,9.17,2028,8.76,46113,13755,32358,4.121,13.814,38708,14089,24619,4.221,11.596,7405,2.218,23.191,1402,1416,6695
2009,46,19201,23100,330913,334206,1914,8.262,2046,8.832,37172,11562,25610,3.46,11.122,43805,11722,32083,3.507,13.107,-6633,-1.985,22.245,1358,1368,7596
2010,46,19203,23205,329167,330005,1951,8.435,1800,7.782,36853,13223,23630,4.007,11.167,38652,10422,28230,3.158,11.713,-1799,-0.545,22.335,1164,1173,5968
2011,46,19087,23187,325676,326950,1875,8.096,1819,7.854,34443,9731,24712,2.976,10.535,37069,9560,27509,2.924,11.338,-2626,-0.803,21.069,1178,1211,6068
2012,46,19219,23410,332069,328790,2054,8.83,1758,7.557,41871,12754,29117,3.879,12.735,35019,11741,23278,3.571,10.651,6852,2.084,21.302,1138,1157,5043
2013,46,19281,23521,339513,335595,1917,8.182,1736,7.409,40050,10025,30025,2.987,11.934,32384,9432,22952,2.811,9.65,7666,2.284,19.299,1126,1134,5437
2014,46,19326,23629,347328,343348,1884,8.001,1721,7.309,38918,11538,27380,3.36,11.335,30813,8374,22439,2.439,8.974,8105,2.361,17.949,1172,1192,5445
2015,46,19559,24001,352682,349772,2078,8.738,1640,6.896,36625,11219,25406,3.208,10.471,30896,9631,21265,2.754,8.833,5729,1.638,17.666,1123,1148,5889
2016,46,19746,24373,358126,355407,2071,8.571,1651,6.833,35793,10482,25311,2.949,10.071,30546,7504,23042,2.111,8.595,5247,1.476,17.189,1189,1204,4937
2017,46,19758,24381,359167,358056,1912,7.854,1840,7.558,40929,11617,29312,3.244,11.431,39229,11434,27795,3.193,10.956,1700,0.475,21.912,1214,1229,6156
2018,46,19818,24424,359004,359068,1923,7.889,1824,7.483,36028,10274,25754,2.861,10.034,35996,11450,24546,3.189,10.025,32,0.009,20.05,1351,1393,6935
1978,47,67793,80476,1359748,1311133,12256,15.485,9601,12.13,281655,99324,182331,7.575,21.482,184056,86545,97511,6.601,14.038,97599,7.444,28.076,6449,6511,34319
1979,47,69416,82518,1427602,1395653,11840,14.577,9250,11.388,258762,97621,161141,6.995,18.541,194272,77254,117018,5.535,13.92,64490,4.621,27.84,6179,6230,34420
1980,47,69014,82915,1422594,1425189,10764,13.063,9730,11.809,219789,91565,128224,6.425,15.422,224570,70836,153734,4.97,15.757,-4781,-0.335,30.843,6959,7050,38169
1981,47,69100,83416,1415392,1417528,10165,12.275,8951,10.809,213599,86427,127172,6.097,15.068,217697,67656,150041,4.773,15.358,-4098,-0.289,30.137,6070,6156,31398
1982,47,68206,83138,1402769,1408186,10990,13.259,10490,12.656,226158,96767,129391,6.872,16.06,236082,68367,167715,4.855,16.765,-9924,-0.705,32.12,7367,7472,35742
1983,47,69415,83966,1418854,1406238,11205,13.53,8904,10.752,257978,119916,138062,8.527,18.345,233898,77760,156138,5.53,16.633,24080,1.712,33.266,5846,5943,35821
1984,47,73903,89354,1536600,1478934,14011,16.267,7561,8.779,296438,113835,182603,7.697,20.044,180851,63586,117265,4.299,12.228,115587,7.816,24.457,5686,5786,32716
1985,47,75079,90871,1596680,1559697,12637,14.143,9596,10.74,289029,109982,179047,7.052,18.531,214788,82463,132325,5.287,13.771,74241,4.76,27.542,6830,6912,38195
1986,47,76149,92412,1648461,1613685,12675,13.959,9448,10.405,298165,110122,188043,6.824,18.477,227261,80313,146948,4.977,14.083,70904,4.394,28.167,6609,6726,43112
1987,47,78039,95421,1678623,1672909,13965,14.972,9674,10.371,320985,127172,193813,7.602,19.187,308952,91648,217304,5.478,18.468,12033,0.719,36.936,6684,6768,47470
1988,47,80530,99549,1774738,1731504,14336,14.731,9880,10.152,354274,154571,199703,8.927,20.46,268425,101363,167062,5.854,15.502,85849,4.958,31.005,6825,6953,47322
1989,47,82267,102321,1837003,1801530,14001,13.963,9908,9.881,329475,129518,199957,7.189,18.289,257472,90068,167404,5,14.292,72003,3.997,28.584,6986,7220,46671
1990,47,83304,103950,1885148,1855924,12865,12.543,10105,9.852,305366,116097,189269,6.255,16.454,246742,83313,163429,4.489,13.295,58624,3.159,26.59,7294,7450,47368
1991,47,82729,104707,1849311,1864250,12845,12.393,10733,10.355,281852,115509,166343,6.196,15.119,311208,102191,209017,5.482,16.693,-29356,-1.575,30.238,7564,7744,61015
1992,47,83344,105493,1915918,1876388,12306,11.784,10184,9.752,331360,116626,214734,6.215,17.659,253209,85756,167453,4.57,13.494,78151,4.165,26.989,6671,6828,44036
1993,47,85684,107751,1949966,1932018,12594,11.83,10003,9.396,314910,106970,207940,5.537,16.3,276991,100511,176480,5.202,14.337,37919,1.963,28.674,6534,6765,42959
1994,47,87782,110566,2022885,1986132,12960,11.88,10001,9.168,327886,125224,202662,6.305,16.509,254796,99496,155300,5.01,12.829,73090,3.68,25.658,6870,7027,46558
1995,47,90160,113655,2128621,2072613,13593,12.144,10144,9.063,357418,128841,228577,6.216,17.245,244291,83952,160339,4.051,11.787,113127,5.458,23.573,6944,7148,45629
1996,47,91333,115860,2148748,2134023,13810,12.073,10872,9.504,330675,128977,201698,6.044,15.495,301394,106374,195020,4.985,14.123,29281,1.372,28.247,7679,7832,54858
1997,47,92008,117493,2206825,2181251,14253,12.236,12236,10.504,377682,136675,241007,6.266,17.315,325990,112910,213080,5.176,14.945,51692,2.37,29.89,8144,8412,58658
1998,47,92722,119135,2301226,2264536,13611,11.509,11868,10.035,381129,146683,234446,6.477,16.83,306480,106279,200201,4.693,13.534,74649,3.296,27.068,7767,7978,48850
1999,47,92369,119736,2341642,2325569,13240,11.106,12196,10.23,371285,140299,230986,6.033,15.965,341542,124039,217503,5.334,14.686,29743,1.279,29.373,7931,8243,55431
2000,47,91683,119537,2378381,2352006,12494,10.461,12283,10.285,385105,126442,258663,5.376,16.373,333190,127569,205621,5.424,14.166,51915,2.207,28.332,7723,7980,47953
2001,47,90653,119097,2358793,2364778,12535,10.529,12445,10.453,357846,129858,227988,5.491,15.132,369039,124776,244263,5.276,15.606,-11193,-0.473,30.265,7666,7996,63764
2002,47,90226,119148,2301578,2335817,13290,11.157,13224,11.102,365454,135790,229664,5.813,15.646,434798,146218,288580,6.26,18.614,-69344,-2.969,31.291,7871,8139,67237
2003,47,90519,119577,2297687,2298664,12716,10.67,11914,9.997,350926,128658,222268,5.597,15.267,353185,113992,239193,4.959,15.365,-2259,-0.098,30.533,7241,7458,45906
2004,47,91921,121312,2335613,2316427,12683,10.542,10688,8.883,341951,112848,229103,4.872,14.762,303926,101743,202183,4.392,13.12,38025,1.642,26.241,6785,6986,43678
2005,47,92912,123005,2358558,2347331,13357,10.947,11386,9.331,334354,111974,222380,4.77,14.244,311774,91942,219832,3.917,13.282,22580,0.962,26.564,7386,7596,46562
2006,47,94109,125581,2449082,2403716,15220,12.268,12184,9.821,380683,140263,240420,5.835,15.837,289728,96078,193650,3.997,12.053,90955,3.784,24.107,8300,8512,48906
2007,47,94917,127289,2466706,2454547,13904,11.014,11806,9.352,379628,123199,256429,5.019,15.466,357222,115132,242090,4.691,14.553,22406,0.913,29.107,7275,7427,46279
2008,47,94198,127751,2479146,2474428,12879,10.113,12086,9.49,355038,121550,233488,4.912,14.348,345638,92671,252967,3.745,13.968,9400,0.38,27.937,7982,8088,45781
2009,47,91537,124994,2315013,2400234,10666,8.44,13430,10.627,254965,91645,163320,3.818,10.623,425676,108669,317007,4.527,17.735,-170711,-7.112,21.245,8510,8755,54580
2010,47,89792,123238,2262068,2287853,10332,8.338,11671,9.419,266581,87164,179417,3.81,11.652,317302,92702,224600,4.052,13.869,-50721,-2.217,23.304,7268,7496,45522
2011,47,88756,122145,2296914,2279179,10520,8.587,11249,9.182,289995,78706,211289,3.453,12.724,254111,83347,170764,3.657,11.149,35884,1.574,22.298,7053,7289,40888
2012,47,88439,121874,2352591,2325321,10566,8.675,10406,8.544,307335,84250,223085,3.623,13.217,252897,79339,173558,3.412,10.876,54438,2.341,21.752,6275,6446,37850
2013,47,88528,122279,2394520,2373069,10823,8.881,10001,8.206,314382,92678,221704,3.905,13.248,271046,84725,186321,3.57,11.422,43336,1.826,22.843,6191,6348,36864
2014,47,88495,123135,2452191,2423595,10830,8.837,9664,7.886,297477,91208,206269,3.763,12.274,239484,69968,169516,2.887,9.881,57993,2.393,19.763,6198,6320,35660
2015,47,88746,124556,2502495,2474001,11267,9.111,9472,7.66,309253,99676,209577,4.029,12.5,252471,76049,176422,3.074,10.205,56782,2.295,20.41,6074,6229,45000
2016,47,89684,126889,2580889,2540629,11361,9.046,8753,6.97,320822,102531,218291,4.036,12.628,240013,67135,172878,2.642,9.447,80809,3.181,18.894,5977,6131,34986
2017,47,90372,127806,2641255,2619504,11081,8.713,9826,7.726,341999,99504,242495,3.799,13.056,297658,98408,199250,3.757,11.363,44341,1.693,22.726,6232,6420,43350
2018,47,90920,128284,2667611,2650802,10314,8.067,9469,7.406,306495,87340,219155,3.295,11.562,273041,80069,192972,3.021,10.3,33454,1.262,20.601,6578,6929,43427
1978,48,227427,278050,4335941,4121058,49343,18.235,34422,12.721,1100843,433025,667818,10.508,26.713,672367,295182,377185,7.163,16.315,428476,10.397,32.631,23341,23722,149049
1979,48,236050,289255,4640380,4487801,48166,17.102,32940,11.696,1042337,410610,631727,9.149,23.226,738266,293798,444468,6.547,16.451,304071,6.776,32.901,22842,23179,155696
1980,48,240246,297467,4832799,4743554,46824,16.044,35598,12.197,997130,396496,600634,8.359,21.021,815061,270389,544672,5.7,17.182,182069,3.838,34.365,24775,25249,149829
1981,48,249813,311260,5105634,4960039,49059,16.196,32354,10.681,1054924,421694,633230,8.502,21.268,763313,247616,515697,4.992,15.389,291611,5.879,30.779,21117,21600,125228
1982,48,257076,322748,5455422,5276318,52102,16.511,37727,11.956,1222135,493512,728623,9.353,23.163,865066,290826,574240,5.512,16.395,357069,6.767,32.791,26647,27176,160720
1983,48,267963,335014,5254390,5341186,53104,16.271,35824,10.976,1006806,421292,585514,7.888,18.85,1181358,310660,870698,5.816,22.118,-174552,-3.268,37.7,24695,25348,165170
1984,48,279693,348577,5534723,5358714,57368,16.918,38415,11.328,1226974,492866,734108,9.197,22.897,876130,288409,587721,5.382,16.35,350844,6.547,32.699,27688,28388,167241
1985,48,283127,352953,5685453,5557688,55117,15.846,44848,12.894,1208097,489192,718905,8.802,21.737,954941,361437,593504,6.503,17.182,253156,4.555,34.365,32771,33459,213605
1986,48,281997,354225,5585908,5584753,52706,15.063,44045,12.588,1082371,456628,625743,8.176,19.381,1079521,362447,717074,6.49,19.33,2850,0.051,38.66,31941,32612,207974
1987,48,274390,347615,5396844,5472883,50678,14.587,50269,14.47,1059765,486651,573114,8.892,19.364,1207067,441517,765550,8.067,22.055,-147302,-2.691,38.728,34459,35371,229608
1988,48,275544,351665,5497618,5447253,51062,14.635,45556,13.057,1134024,486445,647579,8.93,20.818,1035435,390536,644899,7.169,19.008,98589,1.81,38.017,31610,32641,201127
1989,48,275468,352658,5657990,5549055,48816,13.982,41791,11.97,1124059,443116,680943,7.985,20.257,908891,351184,557707,6.329,16.379,215168,3.878,32.758,29182,30412,198128
1990,48,279876,358562,5896543,5757979,49305,13.964,38357,10.863,1147441,442887,704554,7.692,19.928,868315,322046,546269,5.593,15.08,279126,4.848,30.16,27157,28210,193549
1991,48,281461,364026,5947285,5884319,50131,13.979,39292,10.957,1133412,473444,659968,8.046,19.262,1009298,376672,632626,6.401,17.152,124114,2.109,34.305,27162,28134,222726
1992,48,285890,369574,6010141,5969943,48964,13.446,38108,10.465,1138181,447525,690656,7.496,19.065,1058239,349824,708415,5.86,17.726,79942,1.339,35.452,24733,25592,177459
1993,48,293974,376335,6153020,6077759,48425,13.006,40400,10.851,1163845,413649,750196,6.806,19.149,1016493,378450,638043,6.227,16.725,147352,2.424,33.45,25993,26922,178048
1994,48,301983,386647,6374734,6277413,50686,13.291,40078,10.51,1144086,429501,714585,6.842,18.225,946784,339551,607233,5.409,15.082,197302,3.143,30.165,27337,28208,190026
1995,48,309080,396239,6675509,6519773,51770,13.247,40904,10.467,1246518,473305,773213,7.26,19.119,936804,338346,598458,5.19,14.369,309714,4.75,28.737,27987,28979,187974
1996,48,313858,402685,6802839,6710971,51779,13.008,42502,10.678,1227423,477435,749988,7.114,18.29,1043356,365996,677360,5.454,15.547,184067,2.743,31.094,29133,30146,200828
1997,48,317026,408261,7092596,6959319,53361,13.18,46565,11.501,1430304,547023,883281,7.86,20.552,1162828,434785,728043,6.248,16.709,267476,3.843,33.418,30822,31889,229970
1998,48,322657,416463,7533848,7362956,51900,12.582,43930,10.65,1455563,528934,926629,7.184,19.769,1112782,385096,727686,5.23,15.113,342781,4.655,30.227,27959,29203,182895
1999,48,323206,420717,7690402,7615327,50983,12.201,45282,10.836,1418517,502407,916110,6.597,18.627,1268301,482519,785782,6.336,16.655,150216,1.973,33.309,29518,30626,229755
2000,48,324034,423465,7979690,7843183,49957,11.852,46043,10.923,1490704,532368,958336,6.788,19.006,1219410,479602,739808,6.115,15.547,271294,3.459,31.095,28696,30041,203739
2001,48,325896,428387,8149284,8065590,51806,12.181,45624,10.728,1469133,564444,904689,6.998,18.215,1303668,487487,816181,6.044,16.163,165465,2.051,32.327,28281,29337,218278
2002,48,328356,433938,7947812,8068137,55260,12.822,49360,11.453,1472089,631223,840866,7.824,18.246,1712900,605711,1107189,7.507,21.23,-240811,-2.985,36.491,29510,30817,274721
2003,48,332113,437989,7973183,7964509,52171,11.985,46827,10.757,1375764,496842,878922,6.238,17.274,1355576,494352,861224,6.207,17.02,20188,0.253,34.04,28596,29376,205349
2004,48,336488,444293,8076092,8025983,52264,11.859,45110,10.236,1343627,499667,843960,6.226,16.741,1250038,441658,808380,5.503,15.575,93589,1.166,31.15,28788,29612,199667
2005,48,341855,452612,8235036,8163402,54322,12.124,45232,10.095,1345320,509114,836206,6.237,16.48,1203870,390166,813704,4.779,14.747,141450,1.733,29.494,29355,30133,198092
2006,48,348338,465253,8684141,8461759,62288,13.59,48464,10.574,1558649,591806,966843,6.994,18.42,1116569,404518,712051,4.781,13.195,442080,5.224,26.391,32783,33564,210567
2007,48,353628,474932,8971572,8826593,59226,12.622,47798,10.187,1612739,556964,1055775,6.31,18.271,1321763,457365,864398,5.182,14.975,290976,3.297,29.95,29375,30100,199835
2008,48,356036,479369,9131747,9043949,53706,11.269,48109,10.095,1499408,519140,980268,5.74,16.579,1326537,411829,914708,4.554,14.668,172871,1.911,29.335,30540,31483,201637
2009,48,354465,479684,8869171,9013772,49359,10.287,49652,10.348,1201507,451021,750486,5.004,13.33,1494484,416443,1078041,4.62,16.58,-292977,-3.25,26.659,31622,32532,205906
2010,48,354116,481141,8747191,8808280,48756,10.16,46214,9.631,1190684,462461,728223,5.25,13.518,1307363,370019,937344,4.201,14.842,-116679,-1.325,27.036,28841,29631,179424
2011,48,356070,485469,8942798,8849096,50691,10.501,45172,9.358,1305119,426814,878305,4.823,14.749,1118039,325798,792241,3.682,12.634,187080,2.114,25.269,28995,29848,174149
2012,48,362835,493110,9293948,9121787,52833,10.813,43802,8.965,1446802,456873,989929,5.009,15.861,1098713,366509,732204,4.018,12.045,348089,3.816,24.09,26280,27301,173846
2013,48,368983,501242,9595037,9448000,52928,10.661,43364,8.735,1448085,460189,987896,4.871,15.327,1154005,389250,764755,4.12,12.214,294080,3.113,24.429,26795,27384,172167
2014,48,375835,512303,9899105,9747398,54682,10.801,42625,8.419,1451833,492732,959101,5.055,14.895,1147072,383914,763158,3.939,11.768,304761,3.127,23.536,27401,28120,177443
2015,48,382263,521882,10234448,10074762,55202,10.686,44604,8.634,1499845,514198,985647,5.104,14.887,1180646,379063,801583,3.763,11.719,319199,3.168,23.438,28792,29655,187157
2016,48,388176,533617,10429860,10329951,57333,10.873,44713,8.48,1445265,511089,934176,4.948,13.991,1246400,351109,895291,3.399,12.066,198865,1.925,24.132,30774,31725,201780
2017,48,392983,539225,10553963,10478377,57060,10.649,50253,9.379,1557794,518685,1039109,4.95,14.867,1408820,459888,948932,4.389,13.445,148974,1.422,26.89,32581,33684,225814
2018,48,398649,545159,10780080,10665187,54923,10.141,47788,8.824,1475633,474098,1001535,4.445,13.836,1246646,392074,854572,3.676,11.689,228987,2.147,23.378,34659,35987,231613
1978,49,22954,26492,399203,372559,4937,19.228,3304,12.868,111135,45880,65255,12.315,29.83,58574,25052,33522,6.724,15.722,52561,14.108,31.444,2268,2300,12287
1979,49,23772,27508,429011,414252,4528,16.824,3339,12.406,97275,38089,59186,9.195,23.482,67916,27179,40737,6.561,16.395,29359,7.087,32.79,2284,2347,13399
1980,49,23597,27498,423653,426247,4115,15.052,3795,13.882,79633,31075,48558,7.29,18.682,83945,40440,43505,9.487,19.694,-4312,-1.012,37.365,2685,2725,16582
1981,49,24053,28387,431729,426769,4599,16.56,3368,12.128,82754,36432,46322,8.537,19.391,72292,23136,49156,5.421,16.939,10462,2.451,33.879,2316,2355,12375
1982,49,23780,28444,433803,432066,4251,15.04,3894,13.777,80755,33071,47684,7.654,18.69,77363,25641,51722,5.935,17.905,3392,0.785,35.811,2707,2736,14743
1983,49,24493,29250,427378,429057,4374,15.285,3107,10.857,80353,32734,47619,7.629,18.728,83509,25167,58342,5.866,19.463,-3156,-0.736,37.456,2091,2129,13403
1984,49,25455,30302,459755,442583,4597,15.56,3081,10.429,93231,34263,58968,7.742,21.065,59348,23072,36276,5.213,13.409,33883,7.656,26.819,2154,2216,13164
1985,49,25653,30498,478466,467014,4601,15.281,3823,12.697,91551,33785,57766,7.234,19.603,68506,27009,41497,5.783,14.669,23045,4.935,29.338,2736,2791,17336
1986,49,25593,30657,486335,482923,4543,15.014,3745,12.377,95487,40554,54933,8.398,19.773,88593,31379,57214,6.498,18.345,6894,1.428,36.69,2629,2677,17228
1987,49,25907,30999,495053,489435,4735,15.518,3761,12.326,100903,40369,60534,8.248,20.616,89788,29226,60562,5.971,18.345,11115,2.271,36.69,2513,2573,17331
1988,49,26357,31843,516293,505536,4817,15.35,3895,12.412,108767,49780,58987,9.847,21.515,86894,34602,52292,6.845,17.188,21873,4.327,34.377,2672,2771,18957
1989,49,26563,32206,542758,527322,4550,14.31,3729,11.728,115985,45239,70746,8.579,21.995,85627,34905,50722,6.619,16.238,30358,5.757,32.476,2617,2692,18886
1990,49,27098,32863,571801,556636,4333,13.4,3277,10.135,107127,37299,69828,6.701,19.245,77142,27729,49413,4.982,13.859,29985,5.387,27.717,2325,2395,16230
1991,49,27732,33888,587323,577761,4759,14.364,3244,9.792,106921,42115,64806,7.289,18.506,88196,29737,58459,5.147,15.265,18725,3.241,30.53,2290,2357,20077
1992,49,28595,34823,619871,601778,4793,14.056,3345,9.81,122508,42375,80133,7.042,20.358,86268,30980,55288,5.148,14.336,36240,6.022,28.671,2184,2231,18106
1993,49,29890,36116,656081,637226,4936,13.955,3447,9.745,120043,40808,79235,6.404,18.838,82039,32177,49862,5.05,12.874,38004,5.964,25.749,2267,2374,18532
1994,49,31505,38084,698264,676865,5649,15.248,3578,9.658,130008,47438,82570,7.008,19.207,87104,33725,53379,4.983,12.869,42904,6.339,25.737,2492,2569,21279
1995,49,33121,40034,741235,719123,5916,15.169,3848,9.867,139803,54148,85655,7.53,19.441,95631,34059,61572,4.736,13.298,44172,6.142,26.597,2716,2794,19476
1996,49,34618,41802,773520,754713,6223,15.252,4224,10.352,140080,57402,82678,7.606,18.561,102319,34584,67735,4.582,13.557,37761,5.003,27.115,2990,3067,22164
1997,49,36000,43432,820881,798295,6548,15.376,4856,11.403,169510,64044,105466,8.023,21.234,122693,47652,75041,5.969,15.369,46817,5.865,30.739,3237,3329,23934
1998,49,37094,44811,843256,835159,6322,14.327,4953,11.225,157282,58972,98310,7.061,18.833,140728,43979,96749,5.266,16.85,16554,1.982,33.701,3258,3308,22102
1999,49,38086,46475,880548,869599,6795,14.902,5043,11.059,153932,60193,93739,6.922,17.701,131528,49985,81543,5.748,15.125,22404,2.576,30.25,3407,3508,28822
2000,49,38829,47727,908331,894299,6564,13.951,5213,11.079,159342,59813,99529,6.688,17.818,131484,47755,83729,5.34,14.702,27858,3.115,29.405,3475,3556,24366
2001,49,39826,48760,911977,911030,7040,14.601,5954,12.348,161617,61999,99618,6.805,17.74,162013,62866,99147,6.901,17.784,-396,-0.043,35.48,3552,3645,29200
2002,49,40793,50013,905040,908916,7522,15.244,6185,12.534,165126,65322,99804,7.187,18.167,172577,57255,115322,6.299,18.987,-7451,-0.82,36.335,3731,3807,30689
2003,49,42261,51472,900191,900764,7675,15.138,6134,12.098,153147,61571,91576,6.835,17.002,153343,55395,97948,6.15,17.024,-196,-0.022,34.004,3823,3901,27527
2004,49,43935,53342,919646,899589,7804,14.899,5880,11.226,170882,62815,108067,6.983,18.996,131711,45788,85923,5.09,14.641,39171,4.354,29.282,3730,3775,22684
2005,49,45917,55579,960443,940223,8422,15.473,6126,11.255,175888,61089,114799,6.497,18.707,134816,48390,86426,5.147,14.339,41072,4.368,28.677,3896,3973,24373
2006,49,48909,59216,1026247,993687,10142,17.678,6453,11.248,188245,70277,117968,7.072,18.944,123178,41615,81563,4.188,12.396,65067,6.548,24.792,4468,4560,26864
2007,49,51497,62155,1089636,1063860,9622,15.873,6549,10.804,197900,61874,136026,5.816,18.602,146484,51724,94760,4.862,13.769,51416,4.833,27.538,4221,4246,24793
2008,49,51608,62612,1103179,1095788,8272,13.266,7762,12.448,184163,57945,126218,5.288,16.806,169468,58367,111101,5.326,15.465,14695,1.341,30.931,5302,5359,29070
2009,49,49427,60602,1049744,1076542,6920,11.218,9094,14.742,141516,48908,92608,4.543,13.145,195963,57955,138008,5.383,18.203,-54447,-5.058,26.291,6055,6121,36267
2010,49,48740,59899,1008688,1028779,7250,12.04,7887,13.098,128510,50162,78348,4.876,12.492,167812,49544,118268,4.816,16.312,-39302,-3.82,24.983,4988,5117,28321
2011,49,48798,60108,1020064,1014699,7264,12.114,6975,11.632,137751,46016,91735,4.535,13.576,126978,39817,87161,3.924,12.514,10773,1.062,25.028,4360,4464,24001
2012,49,49759,61225,1055516,1037484,7560,12.473,6336,10.453,154832,46028,108804,4.437,14.924,118425,35386,83039,3.411,11.415,36407,3.509,22.829,3982,4068,22059
2013,49,50826,62534,1093520,1073699,7444,12.041,6025,9.745,159569,56125,103444,5.227,14.862,121008,41196,79812,3.837,11.27,38561,3.591,22.54,3702,3747,21199
2014,49,52065,64060,1142956,1121128,7593,12.003,5988,9.466,166193,55156,111037,4.92,14.824,121830,37906,83924,3.381,10.867,44363,3.957,21.733,3876,3936,22020
2015,49,53276,65786,1202764,1175929,7876,12.136,6101,9.401,181893,60254,121639,5.124,15.468,127820,38704,89116,3.291,10.87,54073,4.598,21.739,4046,4140,23578
2016,49,54485,67578,1245555,1224637,7966,11.95,6137,9.206,170678,52393,118285,4.278,13.937,129048,42422,86626,3.464,10.538,41630,3.399,21.075,4190,4276,24831
2017,49,55748,68889,1277040,1256069,7964,11.679,6571,9.636,179227,55322,123905,4.404,14.269,138130,47444,90686,3.777,10.997,41097,3.272,21.994,4340,4416,27172
2018,49,57403,70504,1336534,1307408,8032,11.53,6345,9.108,187264,57546,129718,4.402,14.323,129328,46657,82671,3.569,9.892,57936,4.431,19.784,4672,4787,31152
1978,50,10888,12065,157039,150798,1912,16.35,1170,10.005,34932,13145,21787,8.717,23.165,22889,12444,10445,8.252,15.179,12043,7.986,30.357,851,860,8384
1979,50,11278,12515,163319,159960,1744,14.23,1225,9.996,27412,9919,17493,6.201,17.137,20919,8056,12863,5.036,13.078,6493,4.059,26.155,865,868,4319
1980,50,11307,12538,163994,163674,1551,12.42,1450,11.612,25282,8540,16742,5.218,15.447,24363,8051,16312,4.919,14.885,919,0.561,29.77,1001,1009,4091
1981,50,11428,12684,168520,166164,1486,11.825,1252,9.963,25518,7879,17639,4.742,15.357,20640,5635,15005,3.391,12.422,4878,2.936,24.843,856,864,3631
1982,50,11598,12951,167404,167594,1778,13.937,1390,10.896,23086,8371,14715,4.995,13.775,23656,7446,16210,4.443,14.115,-570,-0.34,27.55,996,1001,3850
1983,50,11842,13204,167008,166870,1641,12.635,1208,9.301,23079,8313,14766,4.982,13.831,22832,5267,17565,3.156,13.683,247,0.148,27.365,855,860,3481
1984,50,12747,14141,177436,172001,2123,15.59,1077,7.909,29452,10219,19233,5.941,17.123,18634,5948,12686,3.458,10.834,10818,6.289,21.667,797,801,3530
1985,50,13281,14714,182476,178941,2196,15.308,1458,10.164,30030,11061,18969,6.181,16.782,22979,8660,14319,4.84,12.842,7051,3.94,25.683,1080,1097,5220
1986,50,13651,15138,191286,185924,2245,15.16,1587,10.716,34959,14078,20881,7.572,18.803,24585,8698,15887,4.678,13.223,10374,5.58,26.446,1159,1167,5723
1987,50,14421,16053,206649,199256,2478,15.936,1471,9.46,41257,17240,24017,8.652,20.706,26253,10717,15536,5.379,13.176,15004,7.53,26.351,1070,1076,5872
1988,50,15204,16940,213198,209671,2512,15.246,1584,9.614,39457,17575,21882,8.382,18.819,32598,11591,21007,5.528,15.547,6859,3.271,31.095,1171,1182,6900
1989,50,15775,17613,220696,216611,2500,14.532,1682,9.777,35633,13050,22583,6.025,16.45,27540,11244,16296,5.191,12.714,8093,3.736,25.428,1318,1335,7011
1990,50,15801,17694,215772,217387,2078,11.819,1854,10.545,30219,10527,19692,4.843,13.901,33481,10107,23374,4.649,15.402,-3262,-1.501,27.802,1454,1466,6729
1991,50,15421,17451,205372,209782,1848,10.571,1910,10.926,27142,11562,15580,5.511,12.938,36072,10681,25391,5.091,17.195,-8930,-4.257,25.876,1437,1445,7884
1992,50,15304,17335,206935,206482,1778,10.276,1712,9.895,30343,10082,20261,4.883,14.695,29410,8577,20833,4.154,14.243,933,0.452,28.487,1171,1179,5682
1993,50,15593,17650,211614,208856,1958,11.207,1602,9.169,33051,10794,22257,5.168,15.825,27566,11167,16399,5.347,13.199,5485,2.626,26.397,1142,1168,4943
1994,50,15825,17915,214327,214385,1835,10.324,1554,8.743,30320,9907,20413,4.621,14.143,30147,9246,20901,4.313,14.062,173,0.081,28.124,1096,1116,5229
1995,50,16115,18252,218767,218130,1893,10.478,1522,8.424,31696,10704,20992,4.907,14.531,30102,11063,19039,5.072,13.8,1594,0.731,27.6,1092,1102,6798
1996,50,16157,18364,222339,221548,1897,10.39,1685,9.229,31605,11825,19780,5.337,14.266,29880,12236,17644,5.523,13.487,1725,0.779,26.974,1221,1242,6528
1997,50,16345,18581,227772,224825,2026,10.98,1767,9.576,34292,14604,19688,6.496,15.253,28682,10398,18284,4.625,12.757,5610,2.495,25.515,1242,1255,6079
1998,50,16496,18676,237891,233506,1859,9.978,1770,9.5,35533,11501,24032,4.925,15.217,26739,9665,17074,4.139,11.451,8794,3.766,22.902,1191,1221,5660
1999,50,16728,19057,244721,241407,1949,10.339,1537,8.153,34084,11650,22434,4.826,14.119,27233,9068,18165,3.756,11.281,6851,2.838,22.562,1130,1146,5854
2000,50,16774,19171,253895,249233,1819,9.528,1659,8.69,38100,12683,25417,5.089,15.287,28778,9597,19181,3.851,11.547,9322,3.74,23.093,1162,1172,5106
2001,50,16669,19143,254651,252511,1675,8.77,1587,8.309,32478,10319,22159,4.087,12.862,28246,9348,18898,3.702,11.186,4232,1.676,22.372,1118,1132,5871
2002,50,16561,19088,255109,256709,1839,9.617,1909,9.983,37584,14195,23389,5.53,14.641,40711,14023,26688,5.463,15.859,-3127,-1.218,29.281,1151,1177,6431
2003,50,16646,19270,252748,253789,1856,9.693,1613,8.424,33319,10041,23278,3.956,13.129,35669,12889,22780,5.079,14.055,-2350,-0.926,26.257,1002,1025,6103
2004,50,16911,19537,253041,253145,1842,9.502,1537,7.929,27264,9195,18069,3.632,10.77,27630,7483,20147,2.956,10.915,-366,-0.145,21.54,1002,1015,4464
2005,50,17035,19733,259274,256231,1871,9.536,1647,8.394,33992,10952,23040,4.274,13.266,27714,8500,19214,3.317,10.816,6278,2.45,21.632,1083,1095,5289
2006,50,17126,19948,261796,260525,2031,10.25,1763,8.898,30780,9950,20830,3.819,11.815,28208,8494,19714,3.26,10.827,2572,0.987,21.655,1270,1281,5273
2007,50,17167,19969,261013,261319,1906,9.566,1818,9.124,31745,9908,21837,3.792,12.148,32056,10099,21957,3.865,12.267,-311,-0.119,24.296,1120,1130,4454
2008,50,16888,19682,260589,260503,1658,8.377,1878,9.489,30370,10202,20168,3.916,11.658,30492,10139,20353,3.892,11.705,-122,-0.047,23.316,1193,1202,5980
2009,50,16394,19249,254848,257997,1516,7.782,1982,10.173,28069,10880,17189,4.217,10.88,34802,9446,25356,3.661,13.489,-6733,-2.61,21.759,1212,1229,5932
2010,50,16230,19102,253782,254344,1494,7.8,1600,8.353,26395,9116,17279,3.584,10.378,27569,6834,20735,2.687,10.839,-1174,-0.462,20.755,990,998,4058
2011,50,16055,18898,254232,253872,1555,8.197,1701,8.966,27070,7140,19930,2.812,10.663,26240,8210,18030,3.234,10.336,830,0.327,20.672,1069,1090,4416
2012,50,16067,18957,265390,259660,1663,8.798,1554,8.221,36659,9229,27430,3.554,14.118,25563,7823,17740,3.013,9.845,11096,4.273,19.69,1003,1029,4842
2013,50,15946,18871,255877,259808,1447,7.663,1472,7.795,27962,7705,20257,2.966,10.763,35322,16578,18744,6.381,13.595,-7360,-2.833,21.525,934,934,13547
2014,50,15941,18888,259616,258468,1515,8.031,1467,7.777,27249,7555,19694,2.923,10.543,25032,8115,16917,3.14,9.685,2217,0.858,19.37,945,978,5340
2015,50,15997,19011,265132,262252,1472,7.776,1312,6.93,28423,8264,20159,3.151,10.838,22541,5775,16766,2.202,8.595,5882,2.243,17.19,894,905,3568
2016,50,16019,19119,266948,266115,1502,7.885,1362,7.15,26850,7759,19091,2.916,10.09,25290,6650,18640,2.499,9.503,1560,0.586,19.007,927,939,3883
2017,50,15948,19006,258435,259522,1428,7.502,1486,7.807,28093,7461,20632,2.875,10.825,29996,8534,21462,3.288,11.558,-1903,-0.733,21.65,1005,1015,5475
2018,50,15852,18891,261548,259950,1306,6.899,1382,7.301,26566,7779,18787,2.993,10.22,23570,7936,15634,3.053,9.067,2996,1.153,18.134,1024,1040,5220
1978,51,76432,92621,1489604,1433757,13928,15.384,9757,10.777,311408,109454,201954,7.634,21.72,200533,83135,117398,5.798,13.987,110875,7.733,27.973,6304,6401,34581
1979,51,79345,96235,1573393,1529068,13164,13.983,8976,9.535,289424,100927,188497,6.601,18.928,200800,69911,130889,4.572,13.132,88624,5.796,26.264,6106,6172,30892
1980,51,79479,96872,1601162,1603196,12113,12.596,10703,11.13,261491,96322,165169,6.008,16.311,262337,79728,182609,4.973,16.363,-846,-0.053,32.621,7252,7357,34563
1981,51,80198,98471,1630082,1614989,12076,12.415,9680,9.951,258994,111774,147220,6.921,16.037,228551,75833,152718,4.696,14.152,30443,1.885,28.304,6367,6531,34376
1982,51,79829,99239,1639602,1632938,12720,12.934,10928,11.112,267220,114392,152828,7.005,16.364,253693,78229,175464,4.791,15.536,13527,0.828,31.072,7433,7550,38377
1983,51,82816,102565,1644738,1631461,13294,13.278,8405,8.395,262939,93175,169764,5.711,16.117,235620,65504,170116,4.015,14.442,27319,1.675,28.885,5646,5790,32958
1984,51,87194,107720,1772297,1702050,15895,15.212,9429,9.024,327453,115795,211658,6.803,19.239,185918,66370,119548,3.899,10.923,141535,8.316,21.846,6820,6920,36854
1985,51,90819,111992,1878830,1820703,17017,15.516,12387,11.294,349838,131642,218196,7.23,19.214,233970,95166,138804,5.227,12.851,115868,6.364,25.701,9255,9398,56737
1986,51,94084,116381,1992317,1925537,16532,14.603,10194,9.004,375081,152406,222675,7.915,19.479,241674,76604,165070,3.978,12.551,133407,6.928,25.102,6987,7091,38944
1987,51,97490,121649,2097812,2045474,18050,15.248,11502,9.717,410982,165824,245158,8.107,20.092,306294,108075,198219,5.284,14.974,104688,5.118,29.948,7769,7911,47869
1988,51,102385,128212,2208399,2154395,18722,15.003,11880,9.52,417294,169747,247547,7.879,19.369,310350,104861,205489,4.867,14.405,106944,4.964,28.811,8086,8243,51604
1989,51,105496,133057,2299736,2251746,18800,14.475,12444,9.581,408958,164262,244696,7.295,18.162,314078,111074,203004,4.933,13.948,94880,4.214,27.896,8759,8996,53058
1990,51,108007,136834,2354314,2320557,18038,13.44,12791,9.531,389459,149739,239720,6.453,16.783,322382,97163,225219,4.187,13.892,67077,2.891,27.785,9195,9417,55007
1991,51,106504,136768,2249002,2294724,16684,12.274,15018,11.048,329826,145170,184656,6.326,14.373,422437,125516,296921,5.47,18.409,-92611,-4.036,28.746,10329,10693,71854
1992,51,107115,137453,2264691,2249609,16093,11.817,13555,9.953,363609,131416,232193,5.842,16.163,334850,100197,234653,4.454,14.885,28759,1.278,29.77,8689,8909,48686
1993,51,109722,139735,2311052,2286162,15985,11.551,13284,9.599,364771,127932,236839,5.596,15.956,315758,102734,213024,4.494,13.812,49013,2.144,27.623,8344,8623,47652
1994,51,112463,143009,2381136,2352596,16478,11.659,13116,9.281,372748,134267,238481,5.707,15.844,315921,107149,208772,4.555,13.429,56827,2.416,26.857,8614,8840,51768
1995,51,115872,147048,2474483,2429136,17559,12.124,13131,9.066,401400,147214,254186,6.06,16.524,309993,113133,196860,4.657,12.761,91407,3.763,25.523,8803,9075,53533
1996,51,116844,148788,2497718,2479029,16960,11.505,14224,9.649,390904,144135,246769,5.814,15.768,354739,116001,238738,4.679,14.31,36165,1.459,28.619,9560,9861,54601
1997,51,119029,151743,2613866,2554668,18679,12.447,15318,10.208,477558,168177,309381,6.583,18.694,359372,131554,227818,5.15,14.067,118186,4.626,28.135,9570,9976,61080
1998,51,121288,155038,2695781,2662542,18164,11.844,14809,9.656,443328,165499,277829,6.216,16.651,375426,139612,235814,5.244,14.1,67902,2.55,28.201,9041,9414,60656
1999,51,121994,156335,2776054,2735675,17077,10.989,15221,9.794,449137,156042,293095,5.704,16.418,367855,126002,241853,4.606,13.447,81282,2.971,26.893,9254,9594,58813
2000,51,122979,158109,2891171,2838383,17245,10.984,15037,9.577,491200,167157,324043,5.889,17.306,386383,146133,240250,5.148,13.613,104817,3.693,27.226,9144,9462,56074
2001,51,123972,159640,2935043,2916089,17456,11.007,15366,9.689,476721,179649,297072,6.161,16.348,438656,137082,301574,4.701,15.043,38065,1.305,30.085,9078,9460,59101
2002,51,125323,162064,2914078,2930968,19180,11.93,16595,10.322,484904,193082,291822,6.588,16.544,518560,183035,335525,6.245,17.692,-33656,-1.148,33.088,9546,9892,80977
2003,51,127413,164584,2922556,2916179,18527,11.359,15564,9.542,438431,149146,289285,5.114,15.034,427412,144973,282439,4.971,14.657,11019,0.378,29.313,9068,9384,55893
2004,51,131278,169295,3032715,2979350,19366,11.611,14370,8.615,479045,157019,322026,5.27,16.079,371311,118493,252818,3.977,12.463,107734,3.616,24.926,8804,8988,52647
2005,51,134721,173358,3063088,3052507,20143,11.766,15810,9.235,447834,160355,287479,5.253,14.671,425745,126552,299193,4.146,13.947,22089,0.724,27.895,9830,10119,54933
2006,51,138315,179334,3181925,3122018,23294,13.23,16756,9.517,514256,186369,327887,5.97,16.472,394702,128937,265765,4.13,12.643,119554,3.829,25.285,11539,11710,67268
2007,51,139555,181928,3181773,3180586,20804,11.535,17655,9.789,491788,169550,322238,5.331,15.462,489660,147221,342439,4.629,15.395,2128,0.067,30.791,10833,10990,60083
2008,51,138250,180374,3160555,3170306,18032,9.967,19126,10.571,441552,136865,304687,4.317,13.928,462749,153749,309000,4.85,14.596,-21197,-0.669,27.855,11920,12128,60907
2009,51,134797,178035,3046991,3106701,16808,9.372,19411,10.824,371206,146910,224296,4.729,11.949,491804,139723,352081,4.497,15.83,-120598,-3.882,23.897,12311,12541,69626
2010,51,133092,176382,2996532,3022635,16306,9.213,17505,9.891,367619,124958,242661,4.134,12.162,419297,135293,284004,4.476,13.872,-51678,-1.71,24.324,10366,10714,61302
2011,51,132242,176333,3028672,3013358,17302,9.823,16899,9.595,397298,126769,270529,4.207,13.185,366692,108233,258459,3.592,12.169,30606,1.016,24.338,10321,10628,51373
2012,51,132846,176663,3085750,3056870,16493,9.358,15658,8.884,436148,119402,316746,3.906,14.268,377644,110062,267582,3.6,12.354,58504,1.914,24.708,9046,9312,47329
2013,51,133239,177494,3109877,3093377,16950,9.586,15591,8.818,409335,132927,276408,4.297,13.233,377557,118087,259470,3.817,12.205,31778,1.027,24.411,8942,9111,50245
2014,51,133693,179099,3135366,3121032,16681,9.367,14631,8.216,385200,125806,259394,4.031,12.342,355028,100535,254493,3.221,11.375,30172,0.967,22.751,9255,9410,43740
2015,51,134663,180685,3203023,3173176,16966,9.442,14955,8.323,406149,138746,267403,4.372,12.799,346917,106910,240007,3.369,10.933,59232,1.867,21.866,9177,9364,47655
2016,51,135969,183538,3264584,3234346,17461,9.599,14212,7.813,407711,132492,275219,4.096,12.606,347598,100237,247361,3.099,10.747,60113,1.859,21.494,9326,9564,49460
2017,51,136785,184185,3299925,3277473,16431,8.947,15351,8.359,414306,115172,299134,3.514,12.641,368589,113906,254683,3.475,11.246,45717,1.395,22.492,9787,10003,56221
2018,51,137189,184297,3373623,3337281,15716,8.54,15178,8.248,413832,116947,296885,3.504,12.4,341971,104333,237638,3.126,10.247,71861,2.153,20.494,10514,10834,57359
1978,53,71690,83889,1137730,1071259,15256,18.877,9116,11.28,280625,92622,188003,8.646,26.196,147126,62938,84188,5.875,13.734,133499,12.462,27.468,6256,6323,32897
1979,53,75217,87851,1215057,1164198,14080,16.475,9299,10.881,275185,91971,183214,7.9,23.637,172722,64663,108059,5.554,14.836,102463,8.801,29.672,6310,6407,33348
1980,53,75305,88249,1247756,1233547,12984,14.834,11549,13.194,243977,90209,153768,7.313,19.778,216056,73451,142605,5.954,17.515,27921,2.263,35.03,7828,7940,44875
1981,53,76227,89830,1249962,1247252,12517,14.138,9930,11.216,216605,87362,129243,7.004,17.367,210263,59835,150428,4.797,16.858,6342,0.508,33.716,6637,6726,32756
1982,53,75790,90442,1237671,1242867,13528,15.116,11629,12.994,223043,91701,131342,7.378,17.946,233322,65236,168086,5.249,18.773,-10279,-0.827,35.892,7862,7943,38623
1983,53,79074,93878,1240339,1233437,13976,15.29,9038,9.887,232154,93512,138642,7.581,18.822,216091,58662,157429,4.756,17.519,16063,1.302,35.039,5971,6123,34919
1984,53,83836,98947,1326991,1287349,15369,16.057,8901,9.3,258860,92456,166404,7.182,20.108,181565,55087,126478,4.279,14.104,77295,6.004,28.208,6368,6442,30098
1985,53,85075,100310,1359062,1331411,14688,14.879,11494,11.644,259916,97622,162294,7.332,19.522,204590,74268,130322,5.578,15.366,55326,4.155,30.733,8079,8224,44541
1986,53,86442,102183,1408102,1378363,15164,15.128,11275,11.248,285702,103757,181945,7.528,20.728,226560,80495,146065,5.84,16.437,59142,4.291,32.874,7886,8024,44465
1987,53,88220,104673,1446570,1412978,15851,15.442,11804,11.499,306356,119158,187198,8.433,21.682,239193,82780,156413,5.859,16.928,67163,4.753,33.857,8115,8271,45625
1988,53,91522,109015,1517725,1481683,16179,15.168,11475,10.758,317039,113483,203556,7.659,21.397,244913,91763,153150,6.193,16.529,72126,4.868,33.059,7706,7914,46397
1989,53,94091,112561,1629125,1573613,16341,14.85,11297,10.266,336765,122913,213852,7.811,21.401,224743,77331,147412,4.914,14.282,112022,7.119,28.564,7947,8095,48531
1990,53,98096,117183,1720264,1673131,16968,14.858,11007,9.638,329942,107580,222362,6.43,19.72,237595,94683,142912,5.659,14.201,92347,5.519,28.401,7824,8028,47890
1991,53,99927,120727,1726240,1720124,17034,14.404,12095,10.228,310924,125334,185590,7.286,18.076,299171,97783,201388,5.685,17.392,11753,0.683,34.785,8372,8544,55077
1992,53,102739,124012,1798560,1756907,16944,13.946,11920,9.811,347359,124532,222827,7.088,19.771,262867,88902,173965,5.06,14.962,84492,4.809,29.924,7875,8031,45765
1993,53,105998,127041,1817592,1807488,16767,13.385,13220,10.553,305187,98795,206392,5.466,16.885,285828,99628,186200,5.512,15.814,19359,1.071,31.627,8525,8794,47679
1994,53,109262,130901,1882877,1864161,17488,13.574,13363,10.372,308848,111815,197033,5.998,16.568,271716,81299,190417,4.361,14.576,37132,1.992,29.152,9106,9310,47973
1995,53,111516,133724,1931290,1905422,17603,13.327,14329,10.848,312721,113060,199661,5.934,16.412,261053,91434,169619,4.799,13.701,51668,2.712,27.401,9872,10111,54425
1996,53,112988,135940,1950825,1931159,18236,13.577,14978,11.152,314157,119878,194279,6.208,16.268,274493,90186,184307,4.67,14.214,39664,2.054,28.428,10222,10465,57329
1997,53,114766,138178,2004077,1966849,18929,13.837,16177,11.825,386514,137816,248698,7.007,19.651,311077,118672,192405,6.034,15.816,75437,3.835,31.632,10398,10632,60608
1998,53,117370,141406,2089455,2058260,18032,12.901,14757,10.558,356277,118951,237326,5.779,17.31,293677,99851,193826,4.851,14.268,62600,3.041,28.536,9732,9900,52688
1999,53,118119,142782,2151750,2120360,17394,12.267,15428,10.88,367241,136551,230690,6.44,17.32,304681,108205,196476,5.103,14.369,62560,2.95,28.739,10232,10643,58906
2000,53,118784,143828,2228295,2197150,17148,11.989,15553,10.874,389697,132009,257688,6.008,17.736,325340,110714,214626,5.039,14.807,64357,2.929,29.615,10079,10442,55887
2001,53,119055,144907,2255413,2241068,17324,12.026,15621,10.844,362976,130173,232803,5.809,16.197,335262,108498,226764,4.841,14.96,27714,1.237,29.92,9944,10211,58154
2002,53,118454,145420,2157243,2208373,18218,12.563,17412,12.007,341195,139385,201810,6.312,15.45,444764,137688,307076,6.235,20.14,-103569,-4.69,30.9,10768,11030,71829
2003,53,120225,147070,2203951,2192214,17786,12.183,15634,10.709,353104,113179,239925,5.163,16.107,330781,110087,220694,5.022,15.089,22323,1.018,30.178,9609,9767,46722
2004,53,122628,150053,2252791,2229100,18016,12.141,14687,9.898,333116,106816,226300,4.792,14.944,286895,89408,197487,4.011,12.87,46221,2.074,25.741,9429,9609,48313
2005,53,126345,154387,2317170,2288891,20025,13.168,15389,10.12,359002,125497,233505,5.483,15.685,301628,100921,200707,4.409,13.178,57374,2.507,26.356,9858,10074,50517
2006,53,130213,159760,2413652,2366618,22943,14.629,17084,10.893,407839,150269,257570,6.35,17.233,316200,102251,213949,4.321,13.361,91639,3.872,26.722,12206,12369,60612
2007,53,132992,163326,2491924,2450865,20764,12.876,16626,10.31,399933,125232,274701,5.11,16.318,315828,101714,214114,4.15,12.886,84105,3.432,25.773,10695,10807,53410
2008,53,132985,163794,2511898,2500758,18450,11.297,17498,10.714,356759,108494,248265,4.338,14.266,334997,105536,229461,4.22,13.396,21762,0.87,26.792,11679,11898,59662
2009,53,127847,159090,2374917,2445773,15259,9.448,20106,12.448,301572,95387,206185,3.9,12.33,442244,114580,327664,4.685,18.082,-140672,-5.752,24.661,13122,13338,65822
2010,53,126140,157483,2288586,2317098,15962,10.098,17128,10.836,277361,104539,172822,4.512,11.97,334108,91034,243074,3.929,14.419,-56747,-2.449,23.94,10882,11115,47706
2011,53,124469,156016,2287301,2273597,15955,10.195,16931,10.818,306870,91733,215137,4.035,13.497,278809,82566,196243,3.632,12.263,28061,1.234,24.526,10742,11079,47682
2012,53,124729,156091,2316994,2300877,15973,10.253,15359,9.859,307444,89116,218328,3.873,13.362,274742,83700,191042,3.638,11.941,32702,1.421,23.882,9158,9354,44213
2013,53,126041,157477,2401635,2368298,16522,10.556,14615,9.337,341859,114579,227280,4.838,14.435,275166,91324,183842,3.856,11.619,66693,2.816,23.237,9010,9151,41892
2014,53,127875,159996,2477792,2439260,16505,10.411,13590,8.572,322831,95864,226967,3.93,13.235,244836,72834,172002,2.986,10.037,77995,3.197,20.075,8868,8998,40737
2015,53,130243,163388,2558307,2515435,17397,10.772,13613,8.429,347344,115293,232051,4.583,13.809,261344,73116,188228,2.907,10.39,86000,3.419,20.779,9083,9228,42578
2016,53,132584,166816,2615128,2568410,17725,10.753,13771,8.354,350560,111655,238905,4.347,13.649,257797,81153,176644,3.16,10.037,92763,3.612,20.074,9368,9481,42408
2017,53,134476,169048,2689085,2649785,17602,10.495,14934,8.904,373618,100255,273363,3.784,14.1,293737,90949,202788,3.432,11.085,79881,3.015,22.171,10013,10146,51059
2018,53,136783,171213,2773197,2732167,17287,10.171,14784,8.698,368233,113356,254877,4.149,13.478,286226,93883,192343,3.436,10.476,82007,3.002,20.952,10953,11270,55647
1978,54,26593,30894,454687,451432,4217,13.777,3645,11.909,78102,27697,50405,6.135,17.301,71267,22868,48399,5.066,15.787,6835,1.514,31.574,2340,2360,10320
1979,54,27499,31970,492022,471961,4575,14.604,3290,10.502,98716,27169,71547,5.757,20.916,58708,23767,34941,5.036,12.439,40008,8.477,24.878,2192,2216,9526
1980,54,27196,31681,479269,488293,3745,11.81,3803,11.993,69163,29380,39783,6.017,14.164,86766,23628,63138,4.839,17.769,-17603,-3.605,28.329,2634,2645,11416
1981,54,27042,31741,480337,479896,3806,12.055,3468,10.984,69291,28651,40640,5.97,14.439,68297,21111,47186,4.399,14.232,994,0.207,28.463,2421,2439,11190
1982,54,26271,31260,488146,483977,3787,12.084,3943,12.582,87842,(S),39891,(S),18.15,78883,24399,54484,5.041,16.299,8959,1.851,32.598,2700,2728,11795
1983,54,26384,31360,429428,451328,3724,12,3073,9.902,59943,26861,33082,5.952,13.281,103023,33590,69433,7.442,22.827,-43080,-9.545,26.563,2054,2104,11375
1984,54,27093,32167,441350,434147,4505,14.287,3237,10.265,72085,27340,44745,6.297,16.604,57276,20194,37082,4.651,13.193,14809,3.411,26.386,2361,2405,10809
1985,54,27149,32191,443797,441676,4355,13.563,4191,13.052,70480,30763,39717,6.965,15.957,66355,24779,41576,5.61,15.023,4125,0.934,30.047,3119,3177,16358
1986,54,27037,32093,442584,439801,3874,12.159,3410,10.703,73221,30685,42536,6.977,16.649,67601,23484,44117,5.34,15.371,5620,1.278,30.742,2357,2400,11298
1987,54,27140,32479,445959,442611,4235,13.225,3324,10.38,77237,32255,44982,7.287,17.45,70545,22281,48264,5.034,15.938,6692,1.512,31.877,2260,2283,11289
1988,54,28024,33544,466185,461459,4269,12.949,3116,9.452,82201,35148,47053,7.617,17.813,72786,26466,46320,5.735,15.773,9415,2.04,31.546,2156,2197,13072
1989,54,28352,34045,475506,469731,3965,11.798,3087,9.186,75508,30373,45135,6.466,16.075,63928,22388,41540,4.766,13.61,11580,2.465,27.219,2217,2260,13142
1990,54,28649,34496,491704,482941,3975,11.65,3226,9.454,77582,27772,49810,5.751,16.064,60365,20796,39569,4.306,12.499,17217,3.565,24.999,2376,2422,13301
1991,54,28539,34780,487854,490129,3918,11.364,3314,9.612,71622,29381,42241,5.995,14.613,75955,24851,51104,5.07,15.497,-4333,-0.884,29.226,2291,2333,13863
1992,54,28622,34888,486024,486006,3671,10.599,3167,9.144,74234,26149,48085,5.38,15.274,73814,24427,49387,5.026,15.188,420,0.086,30.376,2025,2070,11657
1993,54,29187,35429,498371,491853,3729,10.622,3083,8.782,78614,26007,52607,5.288,15.983,65611,22664,42947,4.608,13.34,13003,2.644,26.679,2049,2087,10619
1994,54,29674,36146,508976,505458,3817,10.667,3092,8.641,74661,26160,48501,5.176,14.771,67827,22532,45295,4.458,13.419,6834,1.352,26.838,2160,2178,12184
1995,54,30360,37001,529614,519910,4060,11.118,3091,8.465,83573,29429,54144,5.66,16.075,63736,22117,41619,4.254,12.259,19837,3.815,24.518,2122,2147,11389
1996,54,30358,37186,522908,525136,3857,10.428,3459,9.352,74846,28765,46081,5.478,14.253,79327,25530,53797,4.862,15.106,-4481,-0.853,28.505,2374,2408,14336
1997,54,30514,37549,536245,530276,4103,10.994,3646,9.769,86358,31455,54903,5.932,16.285,74235,24678,49557,4.654,13.999,12123,2.286,27.999,2410,2475,12748
1998,54,30621,37901,549843,544698,3722,9.873,3317,8.799,85784,32993,52791,6.057,15.749,75878,23221,52657,4.263,13.93,9906,1.819,27.861,2186,2214,11010
1999,54,30523,37810,544100,544762,3583,9.487,3500,9.267,74784,29116,45668,5.345,13.728,76274,26531,49743,4.87,14.001,-1490,-0.274,27.456,2305,2368,12472
2000,54,30296,37748,562271,554936,3539,9.385,3458,9.171,81001,29994,51007,5.405,14.596,66558,23370,43188,4.211,11.994,14443,2.603,23.988,2170,2253,11999
2001,54,29688,37137,556904,558474,3253,8.713,3651,9.779,75610,25226,50384,4.517,13.539,78969,26754,52215,4.791,14.14,-3359,-0.601,27.077,2295,2349,11003
2002,54,29409,37034,565255,562887,3627,9.785,3695,9.968,89588,28037,61551,4.981,15.916,84859,26842,58017,4.769,15.076,4729,0.84,30.151,2289,2325,14427
2003,54,29241,36959,562958,563727,3434,9.304,3334,9.033,78560,29336,49224,5.204,13.936,79582,23985,55597,4.255,14.117,-1022,-0.181,27.872,2026,2157,13144
2004,54,29514,37340,568065,565010,3515,9.479,2999,8.087,74124,22337,51787,3.953,13.119,68680,23077,45603,4.084,12.156,5444,0.964,24.311,1958,2015,10279
2005,54,29554,37536,568914,568316,3657,9.789,3303,8.841,76273,25385,50888,4.467,13.421,74955,22254,52701,3.916,13.189,1318,0.232,26.378,2170,2195,10496
2006,54,29416,37733,589328,579010,3995,10.653,3533,9.421,88325,32841,55484,5.672,15.254,67839,20698,47141,3.575,11.716,20486,3.538,23.433,2507,2547,12804
2007,54,29190,37646,579520,584041,3473,9.239,3362,8.944,79302,26356,52946,4.513,13.578,87742,27271,60471,4.669,15.023,-8440,-1.445,27.156,2158,2198,14199
2008,54,28484,37103,584491,582325,2949,7.906,3347,8.973,76833,21296,55537,3.657,13.194,72682,20974,51708,3.602,12.481,4151,0.713,24.963,2259,2275,10984
2009,54,27858,36697,575426,581004,2743,7.433,3156,8.552,67360,21754,45606,3.744,11.594,78736,20495,58241,3.528,13.552,-11376,-1.958,23.187,2108,2143,11269
2010,54,27218,36174,564145,569732,2484,6.83,2875,7.905,63808,20837,42971,3.657,11.2,74723,18277,56446,3.208,13.115,-10915,-1.916,22.399,1814,1882,9382
2011,54,26744,35902,571219,567654,2727,7.582,2854,7.935,68534,17571,50963,3.095,12.073,61118,16481,44637,2.903,10.767,7416,1.306,21.534,1861,1924,10865
2012,54,26546,35695,581832,576174,2641,7.392,2703,7.566,73147,18892,54255,3.279,12.695,61749,19244,42505,3.34,10.717,11398,1.978,21.434,1625,1679,8256
2013,54,26048,35237,577079,578236,2529,7.147,2824,7.981,65950,18419,47531,3.185,11.405,68195,22735,45460,3.932,11.794,-2245,-0.388,22.811,1718,1740,9449
2014,54,25516,34848,573319,574913,2409,6.884,2697,7.707,63597,20235,43362,3.52,11.062,66418,20159,46259,3.506,11.553,-2821,-0.491,22.124,1731,1760,9110
2015,54,25265,34730,565494,569856,2614,7.525,2630,7.571,59540,17639,41901,3.095,10.448,67488,17883,49605,3.138,11.843,-7948,-1.395,20.897,1696,1728,9097
2016,54,24966,34600,558974,562006,2500,7.223,2527,7.301,61700,19442,42258,3.459,10.979,67955,17785,50170,3.165,12.092,-6255,-1.113,21.957,1751,1812,11383
2017,54,24526,34093,547843,552522,2419,7.057,2793,8.148,59419,15943,43476,2.885,10.754,69366,18812,50554,3.405,12.554,-9947,-1.8,21.508,1727,1761,8680
2018,54,24089,33620,554399,551084,2198,6.505,2533,7.497,64525,18428,46097,3.344,11.709,58074,18489,39585,3.355,10.538,6451,1.171,21.076,1808,1859,10932
1978,55,78990,91152,1544390,1481501,12192,13.672,8240,9.24,281282,88299,192983,5.96,18.986,156220,62408,93812,4.212,10.545,125062,8.442,21.089,5640,5687,30624
1979,55,81099,93692,1613218,1579101,10905,11.835,7812,8.478,251509,80375,171134,5.09,15.927,183231,65548,117683,4.151,11.604,68278,4.324,23.207,5130,5184,25187
1980,55,80599,93698,1601584,1606004,9626,10.309,8971,9.608,208955,74727,134228,4.653,13.011,218509,62005,156504,3.861,13.606,-9554,-0.595,26.022,6338,6413,32290
1981,55,81455,94998,1583125,1591036,9592,10.208,7536,8.02,209426,90919,118507,5.714,13.163,224176,51717,172459,3.251,14.09,-14750,-0.927,26.326,4996,5094,23768
1982,55,80625,94779,1574736,1578111,10054,10.645,9399,9.951,222493,96266,126227,6.1,14.099,230631,65762,164869,4.167,14.614,-8138,-0.516,28.197,6420,6535,28202
1983,55,82711,96846,1524683,1541691,10603,11.15,7106,7.472,212705,83146,129559,5.393,13.797,246272,61509,184763,3.99,15.974,-33567,-2.177,27.594,4688,4798,26703
1984,55,85394,99780,1602841,1557848,12030,12.317,7816,8.002,257174,81089,176085,5.205,16.508,166843,53772,113071,3.452,10.71,90331,5.798,21.42,5499,5575,27138
1985,55,85588,99971,1630570,1606746,11295,11.404,9448,9.539,246251,86494,159757,5.383,15.326,199722,69232,130490,4.309,12.43,46529,2.896,24.86,6860,7015,40317
1986,55,85638,100224,1648223,1631023,11110,11.181,9398,9.458,249690,91264,158426,5.596,15.309,215391,77858,137533,4.774,13.206,34299,2.103,26.412,6389,6507,35959
1987,55,87311,103277,1743275,1692074,13180,13.038,8804,8.709,305012,130825,174187,7.732,18.026,203551,67430,136121,3.985,12.03,101461,5.996,24.059,6133,6230,37269
1988,55,89496,106478,1829310,1788177,12084,11.531,8722,8.323,301657,110222,191435,6.164,16.87,220346,77399,142947,4.328,12.322,81311,4.547,24.645,6098,6213,39244
1989,55,91022,108947,1909070,1864853,12245,11.422,8769,8.179,297908,97087,200821,5.206,15.975,209088,68980,140108,3.699,11.212,88820,4.763,22.424,6200,6388,36286
1990,55,92876,111252,1968203,1936069,11679,10.652,8448,7.705,277495,94013,183482,4.856,14.333,213380,70464,142916,3.64,11.021,64115,3.312,22.043,6110,6300,37013
1991,55,93087,113002,1957286,1959813,12010,10.761,9211,8.253,257903,94642,163261,4.829,13.16,262872,81169,181703,4.142,13.413,-4969,-0.254,26.319,6533,6724,54444
1992,55,93692,113911,1987675,1969381,11070,9.806,9031,8,267421,81300,186121,4.128,13.579,230764,68599,162165,3.483,11.718,36657,1.861,23.435,6010,6115,35125
1993,55,95801,116088,2043615,2013063,11516,10.026,9064,7.891,286172,88491,197681,4.396,14.216,226075,73645,152430,3.658,11.23,60097,2.985,22.461,6130,6307,37018
1994,55,97439,118433,2104291,2079491,11715,9.989,9400,8.015,278632,91186,187446,4.385,13.399,229164,76241,152923,3.666,11.02,49468,2.379,22.04,6543,6720,42282
1995,55,99214,120698,2182053,2140853,11970,10.023,9434,7.899,299116,98580,200536,4.605,13.972,217292,66640,150652,3.113,10.15,81824,3.822,20.3,6669,6890,39183
1996,55,99857,121886,2196670,2179346,11712,9.686,9764,8.075,275035,89918,185117,4.126,12.62,239892,70617,169275,3.24,11.008,35143,1.613,22.015,6901,7049,37751
1997,55,100806,123244,2255031,2229960,12323,10.063,10751,8.779,327228,110380,216848,4.95,14.674,277015,94542,182473,4.24,12.422,50213,2.252,24.845,7063,7303,46619
1998,55,102146,124907,2316953,2292854,11679,9.41,10082,8.124,315175,95799,219376,4.178,13.746,266300,89592,176708,3.907,11.614,48875,2.132,23.229,6577,6763,41089
1999,55,102472,125930,2359631,2336804,11328,9.043,10014,7.994,316462,98077,218385,4.197,13.543,270800,84420,186380,3.613,11.588,45662,1.954,23.177,6745,6950,42109
2000,55,102676,126906,2415912,2387827,11583,9.174,10281,8.143,334440,111827,222613,4.683,14.006,277925,96477,181448,4.04,11.639,56515,2.367,23.278,6725,6922,41190
2001,55,102395,127105,2389670,2400979,11259,8.879,10669,8.413,285327,92002,193325,3.832,11.884,308515,94361,214154,3.93,12.85,-23188,-0.966,23.768,6815,7139,44145
2002,55,102087,127545,2362374,2384469,12735,10.005,12212,9.594,332861,129279,203582,5.422,13.96,378757,115039,263718,4.825,15.884,-45896,-1.925,27.919,7452,7673,58748
2003,55,102063,127810,2386113,2372841,11653,9.139,11055,8.67,317730,104597,213133,4.408,13.39,290941,86058,204883,3.627,12.261,26789,1.129,24.523,6825,6943,38665
2004,55,102981,129142,2428559,2407065,11544,8.993,9980,7.775,312938,95381,217557,3.963,13.001,269023,88553,180470,3.679,11.176,43915,1.824,22.353,6367,6592,38154
2005,55,104266,130827,2444721,2438648,12308,9.475,10453,8.047,304199,96613,207586,3.962,12.474,290977,82362,208615,3.377,11.932,13222,0.542,23.864,6856,7051,41239
2006,55,104410,132353,2477369,2464586,14202,10.806,12342,9.391,316201,116244,199957,4.717,12.83,289393,85718,203675,3.478,11.742,26808,1.088,23.484,8786,8923,48859
2007,55,104151,132473,2478313,2477324,12385,9.367,11882,8.986,305383,97599,207784,3.94,12.327,303549,91797,211752,3.705,12.253,1834,0.074,24.506,7420,7552,40642
2008,55,102404,131085,2481106,2478879,10766,8.179,11854,9.006,286527,84853,201674,3.423,11.559,281806,85487,196319,3.449,11.368,4721,0.19,22.737,7755,7919,44569
2009,55,99892,128674,2349620,2417668,9639,7.417,12210,9.395,212531,67876,144655,2.807,8.791,347928,97515,250413,4.033,14.391,-135397,-5.6,17.581,7802,7959,52185
2010,55,98305,127214,2319493,2333990,9396,7.351,10624,8.311,232819,76444,156375,3.275,9.975,261982,68029,193953,2.915,11.225,-29163,-1.249,19.95,6587,6783,32938
2011,55,97030,126164,2353370,2335984,9458,7.473,10239,8.091,253829,62734,191095,2.686,10.866,218673,59454,159219,2.545,9.361,35156,1.505,18.722,6422,6652,33254
2012,55,96811,126051,2386038,2369809,9927,7.881,9735,7.729,264205,68698,195507,2.899,11.149,231744,65738,166006,2.774,9.779,32461,1.37,19.558,5885,6064,33235
2013,55,96148,125580,2410813,2397705,9544,7.596,9687,7.709,257958,66675,191283,2.781,10.759,231692,65707,165985,2.74,9.663,26266,1.095,19.326,5784,5888,32389
2014,55,96200,126154,2439976,2414103,9677,7.696,8857,7.044,257732,71227,186505,2.95,10.676,206304,57495,148809,2.382,8.546,51428,2.13,17.092,5618,5745,29391
2015,55,96666,127270,2490059,2464743,10084,7.966,8727,6.894,273280,75177,198103,3.05,11.088,220998,60232,160766,2.444,8.966,52282,2.121,17.933,5627,5732,31743
2016,55,97742,129928,2520728,2505221,11329,8.816,8470,6.592,277555,90834,186721,3.626,11.079,246033,63631,182402,2.54,9.821,31522,1.258,19.642,5667,5792,32150
2017,55,97415,129696,2544461,2528198,9829,7.579,9809,7.564,298871,84381,214490,3.338,11.822,266837,82080,184757,3.247,10.554,32034,1.267,21.109,6205,6351,37730
2018,55,97471,129439,2601314,2578595,9228,7.131,9176,7.09,285935,77619,208316,3.01,11.089,241256,70213,171043,2.723,9.356,44679,1.733,18.712,6405,6641,35700
1978,56,10305,11502,130654,119513,2238,20.117,1484,13.339,41665,15134,26531,12.663,34.862,19202,8503,10699,7.115,16.067,22463,18.795,32.134,1019,1031,4557
1979,56,11011,12322,142246,136499,2204,18.554,1318,11.095,35326,14345,20981,10.509,25.88,24002,8334,15668,6.106,17.584,11324,8.296,35.168,918,924,5246
1980,56,11332,12750,150715,146880,2063,16.511,1552,12.421,33749,13680,20069,9.314,22.977,26169,9250,16919,6.298,17.817,7580,5.161,35.633,1109,1126,6356
1981,56,11631,13164,159759,154883,1998,15.507,1439,11.168,36123,11973,24150,7.73,23.323,26165,7863,18302,5.077,16.893,9958,6.429,33.787,1001,1006,4645
1982,56,11755,13474,159187,159167,2224,16.793,1763,13.312,34144,13894,20250,8.729,21.452,34120,10712,23408,6.73,21.437,24,0.015,42.873,1274,1282,6058
1983,56,11814,13522,138375,148032,1955,14.621,1654,12.37,25161,11151,14010,7.533,16.997,44216,11206,33010,7.57,29.869,-19055,-12.872,33.994,1173,1192,6841
1984,56,11944,13675,138390,137757,1948,14.451,1559,11.565,28383,13337,15046,9.682,20.604,27209,8923,18286,6.477,19.751,1174,0.852,39.503,1069,1081,5044
1985,56,11894,13603,138662,137948,1899,14.051,1723,12.749,27733,11688,16045,8.473,20.104,26333,10199,16134,7.393,19.089,1400,1.015,38.178,1195,1205,5520
1986,56,11517,13238,133871,136261,1659,12.474,1783,13.406,24498,10591,13907,7.773,17.979,29170,10605,18565,7.783,21.407,-4672,-3.429,35.957,1269,1284,6242
1987,56,11005,12652,125049,133040,1566,12.203,1928,15.024,20320,9169,11151,6.892,15.274,36106,10763,25343,8.09,27.139,-15786,-11.866,30.547,1285,1306,5975
1988,56,11134,12795,123128,122933,1658,13.063,1452,11.44,23050,8896,14154,7.236,18.75,22685,9047,13638,7.359,18.453,365,0.297,36.906,951,960,4699
1989,56,11164,12859,127159,125124,1605,12.593,1377,10.804,23533,8692,14841,6.947,18.808,19470,6940,12530,5.546,15.561,4063,3.247,31.121,947,959,4365
1990,56,11302,13003,133547,130227,1553,12.072,1275,9.911,25147,8275,16872,6.354,19.31,18512,7007,11505,5.381,14.215,6635,5.095,28.43,887,908,4303
1991,56,11488,13335,137060,135606,1650,12.582,1208,9.212,23752,8228,15524,6.068,17.516,20639,6945,13694,5.121,15.22,3113,2.296,30.44,868,876,4896
1992,56,11613,13433,139425,138394,1560,11.718,1319,9.908,23766,7659,16107,5.534,17.173,21691,6698,14993,4.84,15.673,2075,1.499,31.347,796,822,3652
1993,56,12015,13968,142808,140981,1858,13.589,1267,9.267,26102,10592,15510,7.513,18.515,22305,7324,14981,5.195,15.821,3797,2.693,31.643,811,829,3969
1994,56,12530,14585,151221,147371,1846,12.929,1233,8.635,27499,10724,16775,7.277,18.66,19753,6095,13658,4.136,13.404,7746,5.256,26.807,818,836,3748
1995,56,12899,14960,153899,158024,1776,12.041,1355,9.187,25350,8890,16460,5.626,16.042,32813,7651,25162,4.842,20.765,-7463,-4.723,32.084,931,943,4829
1996,56,13124,15208,152756,152629,1823,12.131,1463,9.735,22711,8140,14571,5.333,14.88,22604,6276,16328,4.112,14.81,107,0.07,29.62,1026,1057,4402
1997,56,13253,15199,155999,154180,1812,11.943,1757,11.581,29559,10388,19171,6.738,19.172,25898,10660,15238,6.914,16.797,3661,2.374,33.594,1019,1030,4514
1998,56,13600,15622,163899,162157,1844,11.958,1441,9.345,28849,10727,18122,6.615,17.791,25440,9383,16057,5.786,15.688,3409,2.102,31.377,986,1001,4541
1999,56,13565,15695,169649,166723,1774,11.351,1640,10.494,30195,10811,19384,6.484,18.111,24348,8854,15494,5.311,14.604,5847,3.507,29.208,1117,1126,4655
2000,56,13708,15862,174665,171963,1679,10.658,1461,9.274,29393,9120,20273,5.303,17.093,23972,8363,15609,4.863,13.94,5421,3.152,27.88,939,963,4330
2001,56,13849,16036,178152,176025,1806,11.341,1582,9.935,28931,10265,18666,5.832,16.436,24701,8023,16678,4.558,14.033,4230,2.403,28.065,996,1011,4735
2002,56,14126,16367,177661,177556,2040,12.596,1698,10.484,33583,13397,20186,7.545,18.914,33482,12504,20978,7.042,18.857,101,0.057,37.714,1051,1063,6093
2003,56,14340,16584,181833,179722,1884,11.446,1637,9.945,31330,10007,21323,5.568,17.432,27100,9270,17830,5.158,15.079,4230,2.354,30.158,1037,1058,5025
2004,56,14619,16884,188723,185218,1865,11.159,1523,9.113,30540,9204,21336,4.969,16.489,23588,8288,15300,4.475,12.735,6952,3.753,25.471,949,956,4203
2005,56,14979,17331,193401,190998,2071,12.117,1591,9.309,31590,10973,20617,5.745,16.539,26640,7904,18736,4.138,13.948,4950,2.592,27.896,1072,1080,4970
2006,56,15408,17887,206217,199835,2462,14.005,1847,10.507,38447,14723,23724,7.368,19.239,25813,9360,16453,4.684,12.917,12634,6.322,25.834,1322,1334,6372
2007,56,15757,18350,214943,210604,2225,12.306,1685,9.32,37733,11639,26094,5.526,17.917,29015,9132,19883,4.336,13.777,8718,4.14,27.554,1111,1135,4998
2008,56,15827,18446,219306,216404,2019,10.99,1871,10.184,38665,12025,26640,5.557,17.867,33114,11392,21722,5.264,15.302,5551,2.565,30.604,1188,1202,5587
2009,56,15721,18363,211550,214997,1776,9.642,1887,10.245,28877,9048,19829,4.208,13.431,35792,9560,26232,4.447,16.648,-6915,-3.216,26.863,1276,1300,6148
2010,56,15309,17975,201312,205929,1528,8.421,1870,10.305,23373,7618,15755,3.699,11.35,32461,7457,25004,3.621,15.763,-9088,-4.413,22.7,1197,1215,4750
2011,56,15401,18153,204850,203153,1860,10.311,1633,9.052,29934,8606,21328,4.236,14.735,26328,7824,18504,3.851,12.96,3606,1.775,25.919,1049,1059,4339
2012,56,15565,18335,212027,209085,1858,10.199,1622,8.904,32110,9823,22287,4.698,15.357,26293,9655,16638,4.618,12.575,5817,2.782,25.151,1033,1065,5403
2013,56,15512,18330,211048,211315,1731,9.461,1664,9.095,27198,8789,18409,4.159,12.871,27687,8947,18740,4.234,13.102,-489,-0.231,25.742,1079,1091,4951
2014,56,15564,18468,218216,214577,1716,9.34,1526,8.306,30513,8658,21855,4.035,14.22,23057,6025,17032,2.808,10.745,7456,3.475,21.491,1036,1039,3647
2015,56,15804,18727,218843,218312,1821,9.801,1526,8.213,28496,9385,19111,4.299,13.053,27505,7593,19912,3.478,12.599,991,0.454,25.198,1023,1027,3705
2016,56,15625,18674,207597,213172,1801,9.638,1825,9.767,23855,9262,14593,4.345,11.191,35010,9818,25192,4.606,16.423,-11155,-5.233,22.381,1318,1329,6333
2017,56,15597,18571,199143,203046,1793,9.639,1853,9.962,25935,9323,16612,4.592,12.773,33777,10535,23242,5.188,16.635,-7842,-3.862,25.546,1200,1229,4920
2018,56,15785,18696,205319,203062,1888,10.142,1726,9.272,27667,9118,18549,4.49,13.625,23122,8448,14674,4.16,11.387,4545,2.238,22.773,1278,1320,5802
1978,97,214,223,4581,3974,33,15.827,4,1.918,1422,225,1197,5.662,35.783,217,9,208,0.226,5.46,1205,30.322,10.921,0,0,0
1979,97,239,248,4999,4716,38,16.558,(D),(D),930,297,633,6.298,19.722,346,(D),345,(D),7.338,584,12.385,14.675,0,0,0
1980,97,267,273,3984,3820,52,20.635,(S),(S),772,462,310,12.096,20.212,434,(S),348,(S),11.363,338,8.849,22.725,0,0,0
1981,97,364,373,6795,5634,99,30.556,(D),(D),2699,1884,815,33.44,47.906,492,(D),491,(D),8.733,2207,39.173,17.465,0,0,0
1982,97,423,437,10493,8510,93,23.634,6,1.525,4624,3069,1555,36.063,54.336,694,12,682,0.141,8.155,3930,46.181,16.31,(D),(D),(D)
1983,97,226,234,5586,6527,50,22.989,17,7.816,1214,896,318,13.729,18.601,3090,1065,2025,16.318,47.345,-1876,-28.744,37.202,(D),(D),(D)
1984,97,259,269,6311,5897,64,26.834,3,1.258,1776,781,995,13.245,30.12,1001,71,930,1.204,16.976,775,13.143,33.952,(D),(D),(D)
1985,97,284,299,7744,6981,74,27.509,14,5.204,2477,1331,1146,19.066,35.482,962,158,804,2.263,13.78,1515,21.702,27.561,4,4,23
1986,97,302,319,6524,6689,78,27.417,9,3.163,1815,1310,505,19.584,27.134,2089,23,2066,0.344,31.23,-274,-4.096,54.268,4,4,6
1987,97,368,385,6483,5979,192,64.975,13,4.399,2392,1382,1010,23.116,40.01,1366,430,936,7.192,22.849,1026,17.161,45.697,5,5,13
1988,97,362,377,7738,6635,147,46.965,19,6.07,3865,2545,1320,38.36,58.256,1584,725,859,10.928,23.875,2281,34.381,47.75,0,0,0
1989,97,485,510,7854,6934,195,46.707,10,2.395,2972,2389,583,34.456,42.864,1100,160,940,2.308,15.865,1872,26.999,31.73,4,4,15
1990,97,514,539,6658,6004,155,32.225,39,8.108,2628,1674,954,27.881,43.771,1331,649,682,10.809,22.169,1297,21.602,44.337,24,24,445
1991,97,540,566,7336,6466,166,32.709,49,9.655,2675,923,1752,14.275,41.37,976,203,773,3.139,15.094,1699,26.276,30.189,33,33,108
1992,97,550,575,6532,6768,168,32.184,62,11.877,2475,1562,913,23.079,36.569,2837,1831,1006,27.054,41.918,-362,-5.349,73.138,41,41,180
1993,97,408,437,5966,5243,147,39.096,25,6.649,2976,2451,525,46.753,56.767,1510,383,1127,7.306,28.803,1466,27.964,57.606,12,12,43
1994,97,409,431,5384,5087,120,30.691,40,10.23,1635,731,904,14.37,32.141,1010,326,684,6.408,19.855,625,12.286,39.709,27,27,99
1995,97,498,519,6820,6129,144,31.169,30,6.494,2412,996,1416,16.252,39.357,1005,345,660,5.629,16.399,1407,22.958,32.798,20,20,237
1996,97,500,529,7065,6365,147,31.21,31,6.582,2514,1514,1000,23.788,39.5,1196,524,672,8.233,18.792,1318,20.709,37.583,20,20,501
1997,97,519,548,5832,5345,147,30,31,6.327,1840,1005,835,18.804,34.428,824,118,706,2.208,15.418,1016,19.01,30.835,20,20,76
1998,97,501,538,6900,6107,94,18.952,10,2.016,2266,954,1312,15.623,37.108,675,23,652,0.377,11.054,1591,26.054,22.108,(D),(D),(D)
1999,97,514,626,9841,8427,146,25.524,38,6.643,4659,3460,1199,41.059,55.287,1672,1029,643,12.211,19.841,2987,35.446,39.682,21,21,135
2000,97,555,701,11707,10782,125,19.026,37,5.632,3339,718,2621,6.66,30.97,1462,289,1173,2.681,13.56,1877,17.409,27.121,24,24,191
2001,97,592,791,7092,9374,146,19.716,45,6.077,1346,657,689,7.009,14.36,6164,931,5233,9.932,65.76,-4818,-51.4,28.719,30,30,191
2002,97,672,879,7314,6957,153,18.568,43,5.218,2192,1566,626,22.51,31.508,1477,175,1302,2.515,21.23,715,10.277,42.461,26,26,105
2003,97,513,673,5704,6151,126,17.367,231,31.84,1436,571,865,9.284,23.348,2345,1424,921,23.153,38.127,-909,-14.779,46.695,134,134,652
2004,97,373,415,4662,4922,58,11.717,218,44.04,835,272,563,5.526,16.965,1353,872,481,17.716,27.489,-518,-10.524,33.929,82,82,305
2005,97,311,341,3981,4235,82,23.362,102,29.06,849,269,580,6.352,20.047,1365,1036,329,24.463,32.231,-516,-12.184,40.094,65,66,241
2006,97,336,364,2252,2293,176,55,88,27.5,755,582,173,25.387,32.933,868,469,399,20.458,37.863,-113,-4.929,65.867,79,79,392
2007,97,133,152,1827,1673,48,26.446,107,58.953,978,876,102,52.361,58.458,675,555,120,33.174,40.347,303,18.111,80.693,76,76,318
2008,97,130,149,1353,1123,55,42.308,17,13.077,672,517,155,46.058,59.866,176,74,102,6.592,15.679,496,44.187,31.359,12,12,64
2009,97,134,153,1322,1285,41,30.037,8,5.861,261,147,114,11.44,20.311,175,22,153,1.712,13.619,86,6.693,27.237,5,5,9
2010,97,129,148,1312,1267,40,29.851,12,8.955,243,200,43,15.792,19.187,159,23,136,1.816,12.554,84,6.632,25.109,11,11,22
2011,97,122,142,1031,1073,43,33.594,15,11.719,246,170,76,15.851,22.937,334,23,311,2.145,31.142,-88,-8.205,45.874,12,12,18
2012,97,91,110,835,838,23,21.698,15,14.151,126,61,65,7.279,15.036,138,101,37,12.053,16.468,-12,-1.432,30.072,12,12,88
2013,97,81,100,768,719,30,34.884,(D),(D),138,64,74,8.907,19.207,45,(D),19,(D),6.263,93,12.944,12.526,(D),(D),(D)
2014,97,73,149,3494,2116,75,64.378,10,8.584,2867,2841,26,134.294,135.524,144,93,51,4.396,6.807,2723,128.717,13.614,8,8,91
2015,97,90,199,3755,2760,120,84.507,6,4.225,2055,1966,89,71.245,74.47,84,56,28,2.029,3.044,1971,71.426,6.088,5,5,53
2016,97,86,212,3950,3710,63,33.962,10,5.391,1500,889,611,23.965,40.437,1029,996,33,26.85,27.74,471,12.697,55.479,8,8,18
2017,97,45,166,3192,3238,16,9.412,24,14.118,131,117,14,3.613,4.046,212,159,53,4.91,6.547,-81,-2.502,8.091,15,15,135
2018,97,24,24,158,136,17,103.03,(D),(D),144,141,3,103.676,105.882,99,(D),2,(D),72.794,45,33.088,145.588,(D),(D),(D)