"State","Year","Data.DHS Denominator","Data.Number of Firms","Data.Calculated.Net Job Creation","Data.Calculated.Net Job Creation Rate","Data.Calculated.Reallocation Rate","Data.Establishments.Entered","Data.Establishments.Entered Rate","Data.Establishments.Exited","Data.Establishments.Exited Rate","Data.Establishments.Physical Locations","Data.Firm Exits.Count","Data.Firm Exits.Establishment Exit","Data.Firm Exits.Employments","Data.Job Creation.Births","Data.Job Creation.Continuers","Data.Job Creation.Count","Data.Job Creation.Rate","Data.Job Creation.Rate/Births","Data.Job Destruction.Continuers","Data.Job Destruction.Count","Data.Job Destruction.Deaths","Data.Job Destruction.Rate","Data.Job Destruction.Rate/Deaths"
"Alabama","1978","972627","54597","74178","7.627","29.183","10457","16.375","7749","12.135","65213","5248","5329","28257","76167","139930","216097","22.218","7.831","81829","141919","60090","14.591","6.178"
"Alabama","1979","1037995","55893","58099","5.597","31.251","9668","14.701","7604","11.562","66797","5234","5294","29467","76618","143675","220293","21.223","7.381","101842","162194","60352","15.626","5.814"
"Alabama","1980","1064141","54838","-7253","-0.682","32.464","8714","13.168","8871","13.406","66095","6058","6128","32427","65734","106998","172732","16.232","6.177","120563","179985","59422","16.914","5.584"
"Alabama","1981","1051448","54791","-9132","-0.869","31.206","8371","12.687","7516","11.391","66410","5176","5269","27038","70115","93941","164056","15.603","6.668","121251","173188","51937","16.471","4.94"
"Alabama","1982","1037728","53219","-9658","-0.931","33.144","8185","12.497","8621","13.163","65276","6077","6147","34073","73083","98887","171970","16.572","7.043","119658","181628","61970","17.502","5.972"
"Alabama","1983","1012807","53724","-8506","-0.84","33.905","8371","12.942","6970","10.776","65380","4537","4663","27346","66389","105308","171697","16.953","6.555","122786","180203","57417","17.792","5.669"
"Alabama","1984","1054020","57267","99075","9.4","23.015","10726","16.006","5712","8.524","69519","4265","4320","22686","79566","140801","220367","20.907","7.549","82043","121292","39249","11.508","3.724"
"Alabama","1985","1148409","58402","54925","4.783","27.946","10063","14.453","7449","10.699","70932","5377","5480","33204","80918","134476","215394","18.756","7.046","99965","160469","60504","13.973","5.269"
"Alabama","1986","1166259","59182","46862","4.018","30.944","10218","14.4","7555","10.647","72289","5330","5449","30834","90341","136967","227308","19.49","7.746","121713","180446","58733","15.472","5.036"
"Alabama","1987","1196881","60479","16205","1.354","34.303","10683","14.714","7937","10.932","73979","5412","5530","34257","85554","135935","221489","18.506","7.148","133494","205284","71790","17.152","5.998"
"Alabama","1988","1222477","62286","32543","2.662","30.348","10603","14.097","7781","10.345","76624","5451","5547","34052","91978","126064","218042","17.836","7.524","120338","185499","65161","15.174","5.33"
"Alabama","1989","1269650","63461","75754","5.967","26.134","10613","13.766","7861","10.196","78473","5647","5782","33792","94892","146766","241658","19.033","7.474","109951","165904","55953","13.067","4.407"
"Alabama","1990","1335271","64371","48861","3.659","27.082","10084","12.801","7914","10.046","79859","5850","5991","37617","79153","150515","229668","17.2","5.928","121554","180807","59253","13.541","4.438"
"Alabama","1991","1353605","64112","-3138","-0.232","31.36","9871","12.392","8329","10.456","80427","5870","6009","46381","92206","120041","212247","15.68","6.812","139948","215385","75437","15.912","5.573"
"Alabama","1992","1363065","64731","22232","1.631","28.828","9465","11.78","7766","9.666","81195","5277","5409","34547","77922","140781","218703","16.045","5.717","133604","196471","62867","14.414","4.612"
"Alabama","1993","1393469","66352","43687","3.135","25.68","9635","11.774","7741","9.459","82781","5179","5318","30535","66321","156286","222607","15.975","4.759","113610","178920","65310","12.84","4.687"
"Alabama","1994","1438949","68332","34972","2.43","26.703","10521","12.544","8020","9.562","85126","5549","5688","37294","86407","140689","227096","15.782","6.005","127690","192124","64434","13.352","4.478"
"Alabama","1995","1484503","70251","72158","4.861","23.729","10640","12.343","7901","9.165","87575","5581","5720","34054","85993","162297","248290","16.725","5.793","117868","176132","58264","11.865","3.925"
"Alabama","1996","1517424","71167","15826","1.043","28.405","10623","12.066","8413","9.556","89144","6063","6181","39886","82504","148833","231337","15.245","5.437","141224","215511","74287","14.202","4.896"
"Alabama","1997","1541084","71754","25125","1.63","31.529","10794","12.061","9453","10.563","90163","6437","6576","46127","101064","167005","268069","17.395","6.558","153352","242944","89592","15.764","5.814"
"Alabama","1998","1586686","72280","10176","0.641","30.073","10186","11.246","9215","10.174","91061","6205","6376","39593","87481","161273","248754","15.678","5.513","142345","238578","96233","15.036","6.065"
"Alabama","1999","1604978","72253","30058","1.873","28.799","9885","10.848","8925","9.795","91601","6031","6204","39923","103526","157638","261164","16.272","6.45","147329","231106","83777","14.399","5.22"
"Alabama","2000","1637765","71665","33159","2.025","27.515","9293","10.196","9316","10.222","91129","6108","6331","42007","80802","177675","258477","15.782","4.934","141159","225318","84159","13.758","5.139"
"Alabama","2001","1633666","70660","-31958","-1.956","28.731","9546","10.524","9398","10.361","90778","6092","6397","47004","96026","138660","234686","14.366","5.878","177736","266644","88908","16.322","5.442"
"Alabama","2002","1598498","70708","-42166","-2.638","31.991","10202","11.213","9461","10.398","91358","5893","6089","57557","98302","157385","255687","15.995","6.15","195655","297853","102198","18.633","6.393"
"Alabama","2003","1586021","70985","19877","1.253","28.99","9420","10.305","8594","9.401","91829","5589","5665","32841","75279","174494","249773","15.748","4.746","155098","229896","74798","14.495","4.716"
"Alabama","2004","1613771","71716","39087","2.422","26.246","9487","10.298","8224","8.927","92756","5330","5406","34156","82394","168467","250861","15.545","5.106","141043","211774","70731","13.123","4.383"
"Alabama","2005","1655548","72486","42542","2.57","26.97","9912","10.625","8219","8.81","94135","5440","5546","31005","84227","181569","265796","16.055","5.088","158410","223254","64844","13.485","3.917"
"Alabama","2006","1693179","73344","33751","1.993","27.845","11236","11.84","8847","9.322","96097","6198","6317","38401","107056","162427","269483","15.916","6.323","159164","235732","76568","13.922","4.522"
"Alabama","2007","1712797","74189","6838","0.399","29.176","10726","11.087","8573","8.862","97819","5471","5647","34048","91951","164746","256697","14.987","5.368","173759","249859","76100","14.588","4.443"
"Alabama","2008","1710759","73362","-6475","-0.378","27.574","9037","9.286","9280","9.536","97199","6102","6293","36872","77158","158702","235860","13.787","4.51","159529","242335","82806","14.165","4.84"
"Alabama","2009","1659173","71187","-104387","-6.292","20.531","7586","7.905","9806","10.218","94859","6534","6726","35954","62314","108009","170323","10.266","3.756","205032","274710","69678","16.557","4.2"
"Alabama","2010","1586913","69404","-34165","-2.153","22.44","7396","7.892","8699","9.282","93066","5680","5817","29386","61350","116699","178049","11.22","3.866","155189","212214","57025","13.373","3.593"
"Alabama","2011","1578159","68310","23405","1.483","23.568","7457","8.079","8260","8.949","91895","5159","5446","26274","53862","155513","209375","13.267","3.413","131303","185970","54667","11.784","3.464"
"Alabama","2012","1585129","67979","-4835","-0.305","25.601","7737","8.444","7496","8.181","91744","4682","4815","28861","57966","144938","202904","12.8","3.657","149886","207739","57853","13.105","3.65"
"Alabama","2013","1587325","67609","14052","0.885","22.613","7407","8.107","7365","8.061","91387","4563","4650","28415","53164","140362","193526","12.192","3.349","119574","179474","59900","11.307","3.774"
"Alabama","2014","1595733","67538","10381","0.651","22.687","7390","8.077","6669","7.289","91855","4324","4445","25458","61301","130093","191394","11.994","3.842","129652","181013","51361","11.344","3.219"
"Alabama","2015","1615483","67458","33378","2.066","20.442","7711","8.382","6813","7.406","92448","4382","4538","25976","62884","135613","198497","12.287","3.893","112759","165119","52360","10.221","3.241"
"Alabama","2016","1652706","68123","42733","2.586","18.989","7713","8.296","6137","6.601","93762","4155","4274","23426","66167","133482","199649","12.08","4.004","112212","156916","44704","9.494","2.705"
"Alabama","2017","1682109","68250","27931","1.66","22.798","7482","7.989","7140","7.624","93828","4541","4674","28225","54454","165217","219671","13.059","3.237","134737","191740","57003","11.399","3.389"
"Alabama","2018","1712580","68159","29706","1.735","20.239","6695","7.159","6725","7.191","93502","4744","4957","27152","54749","148262","203011","11.854","3.197","126312","173305","46993","10.12","2.744"
"Alaska","1978","107425","7107","-1518","-1.413","65.398","1924","23.813","1291","15.979","8396","828","834","8775","14756","20371","35127","32.699","13.736","18119","36645","18526","34.112","17.246"
"Alaska","1979","106684","7264","1690","1.584","48.422","1658","19.726","1358","16.157","8555","853","865","4695","10369","17150","27519","25.795","9.719","16440","25829","9389","24.211","8.801"
"Alaska","1980","105361","7123","-2981","-2.829","44.185","1431","16.964","1408","16.691","8447","898","911","4314","9344","13933","23277","22.093","8.869","15768","26258","10490","24.922","9.956"
"Alaska","1981","109264","7477","12326","11.281","35.139","1597","18.594","1067","12.423","8854","637","642","3990","11247","20276","31523","28.85","10.293","11910","19197","7287","17.569","6.669"
"Alaska","1982","123553","8073","14568","11.791","41.563","1992","21.786","1203","13.157","9538","783","793","4447","15524","24720","40244","32.572","12.565","17529","25676","8147","20.781","6.594"
"Alaska","1983","131831","9181","7658","5.809","45.278","2520","24.96","1084","10.737","10814","723","741","4986","16529","20974","37503","28.448","12.538","20575","29845","9270","22.639","7.032"
"Alaska","1984","139620","10256","10546","7.553","38.599","2614","23.146","1305","11.555","11948","923","940","5870","16063","21429","37492","26.853","11.505","17977","26946","8969","19.3","6.424"
"Alaska","1985","145820","10566","10056","6.896","41.176","2434","20.261","1821","15.158","12320","1338","1352","7787","15416","24661","40077","27.484","10.572","18115","30021","11906","20.588","8.165"
"Alaska","1986","146531","10460","-2093","-1.428","47.316","2260","18.6","1991","16.386","12285","1456","1485","8005","15146","19520","34666","23.658","10.336","25515","36759","11244","25.086","7.673"
"Alaska","1987","140710","9904","-4238","-3.012","46.643","1903","16.068","2234","18.863","11678","1563","1622","9593","15764","17052","32816","23.322","11.203","22182","37054","14872","26.334","10.569"
"Alaska","1988","137484","10018","-1032","-0.751","44.5","1974","16.806","1706","14.524","11880","1096","1109","5804","13158","17432","30590","22.25","9.571","19163","31622","12459","23.001","9.062"
"Alaska","1989","140590","10323","8617","6.129","32.923","1930","16.082","1348","11.232","12292","930","953","4913","11911","19849","31760","22.591","8.472","14984","23143","8159","16.461","5.803"
"Alaska","1990","151759","10621","14759","9.725","27.951","1918","15.448","1350","10.873","12700","946","972","5597","11297","24671","35968","23.701","7.444","13451","21209","7758","13.975","5.112"
"Alaska","1991","160745","10820","2819","1.754","36.938","1935","15.084","1390","10.835","13101","898","920","5339","12351","20156","32507","20.223","7.684","21126","29688","8562","18.469","5.326"
"Alaska","1992","166512","11012","1036","0.622","41.646","1823","13.855","1339","10.176","13400","827","845","4892","11061","24648","35709","21.445","6.643","26105","34673","8568","20.823","5.146"
"Alaska","1993","166008","11312","-720","-0.434","35.638","1742","12.932","1468","10.898","13607","866","903","4948","8833","20748","29581","17.819","5.321","20304","30301","9997","18.253","6.022"
"Alaska","1994","170636","11684","6147","3.602","32.615","1852","13.424","1446","10.481","13999","913","938","4644","12441","21532","33973","19.91","7.291","18871","27826","8955","16.307","5.248"
"Alaska","1995","174958","12066","3651","2.087","30.542","1890","13.33","1418","10.001","14415","943","970","4796","10268","20101","30369","17.358","5.869","18639","26718","8079","15.271","4.618"
"Alaska","1996","175718","12239","3350","1.906","29.69","1822","12.642","1452","10.075","14597","966","986","5200","8475","20960","29435","16.751","4.823","17644","26085","8441","14.845","4.804"
"Alaska","1997","180611","12441","6598","3.653","33.096","1932","13.16","1590","10.83","14852","1012","1024","4565","10478","26007","36485","20.201","5.801","20617","29887","9270","16.548","5.133"
"Alaska","1998","191940","12723","8589","4.475","29.346","1897","12.624","1598","10.634","15177","990","1026","4591","12673","24079","36752","19.148","6.603","19200","28163","8963","14.673","4.67"
"Alaska","1999","195532","12781","1308","0.669","28.543","1745","11.481","1544","10.158","15300","1017","1037","4300","8803","20410","29213","14.94","4.502","20179","27905","7726","14.271","3.951"
"Alaska","2000","200148","12785","6292","3.144","32.189","1770","11.613","1789","11.738","15232","1074","1106","5987","13510","24995","38505","19.238","6.75","17846","32213","14367","16.095","7.178"
"Alaska","2001","206235","12730","8110","3.932","27.558","1814","11.926","1614","10.611","15311","987","1014","5016","11904","24623","36527","17.711","5.772","18796","28417","9621","13.779","4.665"
"Alaska","2002","211903","12843","1766","0.833","35.736","2134","13.819","1786","11.565","15617","1019","1032","6725","15427","24202","39629","18.701","7.28","25574","37863","12289","17.868","5.799"
"Alaska","2003","214498","13068","6706","3.126","31.301","1966","12.493","1578","10.027","15931","918","941","4746","14183","26093","40276","18.777","6.612","23590","33570","9980","15.651","4.653"
"Alaska","2004","220392","13361","5799","2.631","26.592","1906","11.877","1574","9.808","16214","961","994","4797","9634","25468","35102","15.927","4.371","18583","29303","10720","13.296","4.864"
"Alaska","2005","222901","13551","7249","3.252","25.493","1940","11.875","1549","9.482","16532","1006","1031","4831","10936","24725","35661","15.999","4.906","21082","28412","7330","12.746","3.288"
"Alaska","2006","235770","13794","11869","5.034","25.379","2329","13.922","1793","10.718","16997","1247","1266","5881","12597","29190","41787","17.724","5.343","20469","29918","9449","12.69","4.008"
"Alaska","2007","243150","13833","3408","1.402","32.364","2022","11.866","1755","10.299","17174","1085","1100","4570","14636","28119","42755","17.584","6.019","30504","39347","8843","16.182","3.637"
"Alaska","2008","245718","13678","2598","1.057","26.663","1814","10.638","1875","10.996","17021","1158","1170","4899","9989","25367","35356","14.389","4.065","23988","32758","8770","13.332","3.569"
"Alaska","2009","249232","13561","3811","1.529","28.425","1788","10.513","1808","10.63","16998","1039","1075","4841","12130","27103","39233","15.742","4.867","24563","35422","10859","14.212","4.357"
"Alaska","2010","252452","13603","2361","0.935","24.559","1740","10.216","1539","9.036","17132","898","916","3512","8717","24644","33361","13.215","3.453","23564","31000","7436","12.28","2.946"
"Alaska","2011","253776","13612","1104","0.435","23.964","1763","10.257","1512","8.797","17313","910","933","3174","9705","21806","31511","12.417","3.824","23019","30407","7388","11.982","2.911"
"Alaska","2012","255997","13720","2777","1.085","26.964","1729","9.983","1536","8.869","17416","822","834","3225","10763","26528","37291","14.567","4.204","26958","34514","7556","13.482","2.952"
"Alaska","2013","260965","13795","7469","2.862","20.794","1733","9.94","1551","8.896","17525","895","913","3244","9885","24716","34601","13.259","3.788","19925","27132","7207","10.397","2.762"
"Alaska","2014","263781","13820","1277","0.484","27.117","1748","9.942","1500","8.531","17706","925","932","3855","12959","24083","37042","14.043","4.913","25813","35765","9952","13.559","3.773"
"Alaska","2015","265150","13921","1991","0.751","25.546","1765","9.936","1496","8.421","17899","923","935","4101","10535","25323","35858","13.524","3.973","24747","33867","9120","12.773","3.44"
"Alaska","2016","265204","14034","-1768","-0.667","25.782","1832","10.191","1559","8.672","18114","999","1021","6451","11847","22341","34188","12.891","4.467","25461","35956","10495","13.558","3.957"
"Alaska","2017","261491","13979","-3470","-1.327","26.027","1734","9.613","1720","9.535","18045","1094","1111","5240","8500","25529","34029","13.013","3.251","25020","37499","12479","14.34","4.772"
"Alaska","2018","260765","14037","-591","-0.227","23.537","1594","8.85","1536","8.528","18041","1060","1083","4032","6824","23864","30688","11.768","2.617","23073","31279","8206","11.995","3.147"
"Arkansas","1978","652593","40042","90585","13.881","32.628","9597","20.575","6524","13.987","48180","4429","4518","25194","79242","117807","197049","30.195","12.143","58348","106464","48116","16.314","7.373"
"Arkansas","1979","731918","42294","88969","12.156","29.141","9129","18.512","5878","11.919","50940","3888","3969","23231","71628","123984","195612","26.726","9.786","65180","106643","41463","14.57","5.665"
"Arkansas","1980","802197","43894","26453","3.298","35.077","9121","17.615","6254","12.078","53213","4424","4497","26673","66972","100175","167147","20.836","8.349","92418","140694","48276","17.539","6.018"
"Arkansas","1981","823862","45805","23283","2.826","32.966","9312","17.185","6134","11.32","55776","4076","4155","21916","66337","92742","159079","19.309","8.052","97041","135796","38755","16.483","4.704"
"Arkansas","1982","838339","46899","11169","1.332","36.78","9751","17.294","7312","12.968","57603","5189","5217","28101","71674","93667","165341","19.722","8.55","108337","154172","45835","18.39","5.467"
"Arkansas","1983","846763","49221","15854","1.872","38.4","10150","17.347","6317","10.796","60427","4231","4304","25909","70921","107513","178434","21.072","8.376","113625","162580","48955","19.2","5.781"
"Arkansas","1984","906336","53001","118149","13.036","26.956","11384","18.378","6443","10.402","64413","4424","4532","24992","92625","147682","240307","26.514","10.22","78140","122158","44018","13.478","4.857"
"Arkansas","1985","1011777","56026","113115","11.18","31.769","12067","18.423","7673","11.715","67696","5425","5538","38689","104504","169328","273832","27.064","10.329","98706","160717","62011","15.885","6.129"
"Arkansas","1986","1089120","57692","69183","6.352","35.873","12234","17.931","8169","11.973","70259","5821","5878","38131","112903","151632","264535","24.289","10.366","134194","195352","61158","17.937","5.615"
"Arkansas","1987","1139042","59691","37484","3.291","39.126","12927","18.18","9072","12.759","73033","6262","6340","45772","122004","138313","260317","22.854","10.711","134255","222833","88578","19.563","7.777"
"Arkansas","1988","1170456","61972","48541","4.147","36.304","12863","17.244","9081","12.174","76487","6473","6583","45393","114642","146359","261001","22.299","9.795","136982","212460","75478","18.152","6.449"
"Arkansas","1989","1206541","62661","52222","4.328","34.481","12293","16.126","9442","12.386","77657","6739","6914","47061","108317","151919","260236","21.569","8.977","130133","208014","77881","17.241","6.455"
"Arkansas","1990","1237055","63516","30257","2.446","34.518","11759","15.187","9419","12.165","78597","6729","6934","44754","98117","145645","243762","19.705","7.932","142303","213505","71202","17.259","5.756"
"Arkansas","1991","1247435","64079","9172","0.735","37.263","11940","15.176","9210","11.706","80042","6478","6648","50628","115728","125860","241588","19.367","9.277","149157","232416","83259","18.632","6.674"
"Arkansas","1992","1253559","64975","26914","2.147","34.501","11253","14.11","8959","11.233","80901","5806","5959","38587","95519","147641","243160","19.398","7.62","145816","216246","70430","17.251","5.618"
"Arkansas","1993","1289673","67005","45136","3.5","31.591","11380","13.948","9461","11.596","82546","6012","6183","40642","87225","161622","248847","19.295","6.763","123977","203711","79734","15.796","6.182"
"Arkansas","1994","1365515","69780","99991","7.323","29.468","12813","15.2","9112","10.809","86147","6269","6439","40891","116203","184983","301186","22.057","8.51","122563","201195","78632","14.734","5.758"
"Arkansas","1995","1455041","72463","89201","6.13","28.209","13063","14.908","9474","10.812","89419","6457","6653","48705","114225","180202","294427","20.235","7.85","124941","205226","80285","14.104","5.518"
"Arkansas","1996","1523091","74315","75692","4.97","28.128","13163","14.562","9826","10.871","92059","6772","6962","48554","106799","183103","289902","19.034","7.012","134268","214210","79942","14.064","5.249"
"Arkansas","1997","1615732","76515","85823","5.312","34.063","14532","15.549","11221","12.007","95113","7259","7431","50811","144383","216625","361008","22.343","8.936","162215","275185","112970","17.032","6.992"
"Arkansas","1998","1712490","77938","89080","5.202","30.308","13076","13.598","10927","11.363","97237","7173","7360","50514","137164","211423","348587","20.356","8.01","165104","259507","94403","15.154","5.513"
"Arkansas","1999","1782802","79419","65926","3.698","32.401","13862","14.108","11130","11.327","99623","7082","7351","55373","136915","217832","354747","19.898","7.68","172392","288821","116429","16.2","6.531"
"Arkansas","2000","1860337","80271","77668","4.175","32.351","13673","13.623","11568","11.526","101419","7413","7666","49725","138323","240261","378584","20.35","7.435","185460","300916","115456","16.175","6.206"
"Arkansas","2001","1922592","81513","35537","1.848","33.417","14054","13.752","11935","11.679","103254","7185","7415","50941","137006","219764","356770","18.557","7.126","194650","321233","126583","16.708","6.584"
"Arkansas","2002","1937637","82105","-15008","-0.775","39.816","14800","14.229","12843","12.347","104994","7777","8046","62921","157882","227859","385741","19.908","8.148","262718","400749","138031","20.682","7.124"
"Arkansas","2003","1950453","83660","45262","2.321","35.005","14327","13.539","12156","11.487","106907","7561","7688","51224","138655","247989","386644","19.823","7.109","211507","341382","129875","17.503","6.659"
"Arkansas","2004","2002244","86028","63663","3.18","29.981","14648","13.517","11510","10.621","109939","7236","7453","48009","128196","235611","363807","18.17","6.403","180597","300144","119547","14.99","5.971"
"Arkansas","2005","2093589","89336","119637","5.714","27.867","16478","14.683","11627","10.361","114648","7455","7697","49142","161598","249750","411348","19.648","7.719","192087","291711","99624","13.934","4.759"
"Arkansas","2006","2246637","94664","178704","7.954","25.447","20196","17.076","12520","10.586","122110","8698","8866","59940","184283","280270","464553","20.678","8.203","183076","285849","102773","12.723","4.575"
"Arkansas","2007","2359934","97182","48529","2.056","33.679","18118","14.614","13782","11.117","126144","8814","8987","56817","152730","293201","445931","18.896","6.472","270760","397402","126642","16.84","5.366"
"Arkansas","2008","2346919","96276","-73671","-3.139","29.884","15810","12.566","15991","12.71","125726","10680","10877","69273","130775","219902","350677","14.942","5.572","295264","424348","129084","18.081","5.5"
"Arkansas","2009","2213633","91332","-203247","-9.182","24.934","13023","10.568","18401","14.933","120537","11961","12186","97131","116807","159172","275979","12.467","5.277","315179","479226","164047","21.649","7.411"
"Arkansas","2010","2082807","88457","-59329","-2.849","27.554","13050","10.969","15622","13.131","117683","9735","10016","50969","113395","173551","286946","13.777","5.444","243759","346275","102516","16.625","4.922"
"Arkansas","2011","2080200","87577","53156","2.555","25.753","13497","11.514","13923","11.877","117014","8795","9051","47988","106013","215002","321015","15.432","5.096","172588","267859","95271","12.877","4.58"
"Arkansas","2012","2116068","87774","16544","0.782","28.386","12885","11.021","12467","10.663","117127","7512","7736","41117","101224","215652","316876","14.975","4.784","192985","300332","107347","14.193","5.073"
"Arkansas","2013","2147947","88518","51165","2.382","23.787","12964","11.04","11678","9.945","118071","7152","7249","42593","101208","205422","306630","14.275","4.712","173312","255465","82153","11.893","3.825"
"Arkansas","2014","2200907","89448","53676","2.439","25.85","13260","11.145","11012","9.255","120104","7101","7230","42258","113549","224594","338143","15.364","5.159","201899","284467","82568","12.925","3.752"
"Arkansas","2015","2264930","90727","69334","3.061","23.01","13234","10.953","11296","9.349","121791","7054","7245","40318","111694","218215","329909","14.566","4.931","177228","260575","83347","11.505","3.68"
"Arkansas","2016","2337139","92513","77407","3.312","24.022","13722","11.14","10577","8.587","124748","6985","7191","55674","119133","238982","358115","15.323","5.097","178779","280708","101929","12.011","4.361"
"Arkansas","2017","2404226","94019","66890","2.782","24.056","13686","10.898","11592","9.231","126629","7428","7585","46186","114963","241104","356067","14.81","4.782","190462","289177","98715","12.028","4.106"
"Arkansas","2018","2490499","95482","105417","4.233","20.771","13095","10.295","11478","9.024","128008","8242","8495","46330","116231","247838","364069","14.618","4.667","183384","258652","75268","10.386","3.022"
"California","1978","539707","36821","49070","9.092","27.328","7154","17.401","5227","12.714","42075","3858","3884","17124","49204","73612","122816","22.756","9.117","41945","73746","31801","13.664","5.892"
"California","1979","576411","37250","25963","4.504","28.793","6211","14.777","5171","12.303","42551","3767","3804","17470","40791","68154","108945","18.901","7.077","52465","82982","30517","14.396","5.294"
"California","1980","591536","37057","241","0.041","32.523","5583","13.165","5266","12.417","42567","3924","3985","17371","35458","60976","96434","16.302","5.994","65611","96193","30582","16.262","5.17"
"California","1981","590284","36818","1569","0.266","30.359","5271","12.433","4894","11.543","42585","3376","3416","14736","38031","53140","91171","15.445","6.443","64586","89602","25016","15.179","4.238"
"California","1982","582353","36204","-11046","-1.897","31.029","5560","13.193","5486","13.018","42180","3955","3986","17798","37764","52586","90350","15.515","6.485","71981","101396","29415","17.411","5.051"
"California","1983","573190","37183","2255","0.393","31.335","5808","13.702","4114","9.706","43235","2895","2941","13177","31912","60148","92060","16.061","5.567","62284","89805","27521","15.668","4.801"
"California","1984","596798","39236","50429","8.45","23.414","7062","16.039","4285","9.732","45419","3102","3175","14236","42634","77662","120296","20.157","7.144","44003","69867","25864","11.707","4.334"
"California","1985","633660","39591","34390","5.427","29.156","6355","14.045","5101","11.273","45875","3836","3901","20901","52844","73921","126765","20.005","8.339","54779","92375","37596","14.578","5.933"
"California","1986","651097","39482","19397","2.979","30.251","6034","13.297","5203","11.466","45795","3781","3848","19422","45237","72640","117877","18.104","6.948","63188","98480","35292","15.125","5.42"
"California","1987","671678","39549","21702","3.231","29.952","6398","14.022","5336","11.694","46160","3816","3871","21076","45431","76860","122291","18.207","6.764","64715","100589","35874","14.976","5.341"
"California","1988","694719","40139","19879","2.861","30.099","6324","13.566","5102","10.945","47228","3604","3643","21373","44266","80166","124432","17.911","6.372","66302","104553","38251","15.05","5.506"
"California","1989","712457","40531","25881","3.633","27.666","6049","12.791","4782","10.112","47923","3554","3629","22386","48872","75562","124434","17.465","6.86","61079","98554","37475","13.833","5.26"
"California","1990","738029","41362","27643","3.746","25.818","6163","12.786","4631","9.608","48967","3483","3541","19154","44921","77994","122915","16.654","6.087","65899","95272","29373","12.909","3.98"
"California","1991","753246","41236","7551","1.002","29.49","5998","12.275","4964","10.159","49380","3612","3660","21679","46347","72270","118617","15.747","6.153","76192","111066","34874","14.745","4.63"
"California","1992","774869","41708","16473","2.126","29.429","6025","12.189","4737","9.583","50073","3271","3331","20175","44352","86140","130492","16.841","5.724","79516","114019","34503","14.715","4.453"
"California","1993","796306","43077","28548","3.585","25.776","6340","12.521","4849","9.576","51382","3321","3379","18645","42840","88336","131176","16.473","5.38","67114","102628","35514","12.888","4.46"
"California","1994","825058","44218","26605","3.225","26.776","6710","12.874","4983","9.56","52985","3567","3655","25357","54002","83061","137063","16.613","6.545","66396","110458","44062","13.388","5.34"
"California","1995","858672","45420","44756","5.212","24.002","6765","12.616","5105","9.521","54451","3649","3698","22992","51194","96611","147805","17.213","5.962","61456","103049","41593","12.001","4.844"
"California","1996","882170","45793","14861","1.685","26.37","6477","11.871","5379","9.858","55112","3926","4027","22548","45942","85231","131173","14.869","5.208","80142","116312","36170","13.185","4.1"
"California","1997","895203","46053","8218","0.918","29.708","6733","12.183","6037","10.924","55612","4210","4322","26136","53097","88094","141191","15.772","5.931","82428","132973","50545","14.854","5.646"
"California","1998","922751","46036","31008","3.36","26.554","6376","11.432","5963","10.692","55979","4091","4190","24594","61383","92140","153523","16.638","6.652","77926","122515","44589","13.277","4.832"
"California","1999","943436","46052","11678","1.238","27.748","6351","11.334","5822","10.39","56297","3997","4124","24834","49784","92788","142572","15.112","5.277","82686","130894","48208","13.874","5.11"
"California","2000","968477","46170","39707","4.1","23.72","6342","11.259","5732","10.176","56635","3803","3890","21067","50458","104111","154569","15.96","5.21","73114","114862","41748","11.86","4.311"
"California","2001","986636","45611","1893","0.192","28.709","6183","10.959","6009","10.651","56506","4114","4217","24086","56517","87004","143521","14.547","5.728","95047","141628","46581","14.355","4.721"
"California","2002","980693","46004","-23954","-2.443","30.701","6864","12.064","5877","10.329","57392","3807","3932","24705","53568","96975","150543","15.351","5.462","110753","174497","63744","17.793","6.5"
"California","2003","974066","46517","11289","1.159","26.552","6425","11.137","5295","9.178","58258","3545","3609","17237","45830","94777","140607","14.435","4.705","89251","129318","40067","13.276","4.113"
"California","2004","986354","47068","13631","1.382","26.416","6174","10.554","5262","8.995","58957","3606","3665","19580","47047","96864","143911","14.59","4.77","85514","130280","44766","13.208","4.539"
"California","2005","1004015","47527","16115","1.605","24.377","6495","10.944","5364","9.038","59915","3824","3881","21881","48631","89860","138491","13.794","4.844","86179","122376","36197","12.189","3.605"
"California","2006","1026867","47887","31250","3.043","22.95","7483","12.399","5978","9.905","61105","4387","4471","23301","55309","93776","149085","14.518","5.386","80928","117835","36907","11.475","3.594"
"California","2007","1033552","48029","-14136","-1.368","27.713","6588","10.757","5642","9.213","61715","3771","3815","21751","49684","93528","143212","13.856","4.807","112096","157348","45252","15.224","4.378"
"California","2008","1017922","47447","-13191","-1.296","24.912","5700","9.291","5932","9.67","61231","4007","4087","21950","41422","85371","126793","12.456","4.069","99687","139984","40297","13.752","3.959"
"California","2009","990343","46617","-44083","-4.451","22.402","5383","8.846","6119","10.055","60486","4090","4185","25139","43892","67034","110926","11.201","4.432","111008","155009","44001","15.652","4.443"
"California","2010","966526","46127","-4982","-0.515","23.845","5162","8.573","5277","8.764","60158","3472","3580","20230","39359","75876","115235","11.923","4.072","86280","120217","33937","12.438","3.511"
"California","2011","969367","45703","13419","1.384","22.559","5216","8.712","5260","8.785","59851","3419","3579","16934","39398","83361","122759","12.664","4.064","79056","109340","30284","11.28","3.124"
"California","2012","973269","45646","-2904","-0.298","23.885","5001","8.381","4846","8.122","59746","3088","3165","17744","29737","86498","116235","11.943","3.055","83787","119139","35352","12.241","3.632"
"California","2013","973906","45507","3076","0.316","23.185","5164","8.661","4886","8.194","59766","3164","3246","19218","35851","80123","115974","11.908","3.681","72955","112898","39943","11.592","4.101"
"California","2014","980549","45398","11010","1.123","21.075","4830","8.093","4573","7.663","59808","3107","3164","15675","35568","78765","114333","11.66","3.627","66942","103323","36381","10.537","3.71"
"California","2015","992222","45337","12920","1.302","21.539","5065","8.467","4578","7.653","60061","2973","3038","17254","38191","81588","119779","12.072","3.849","72613","106859","34246","10.77","3.451"
"California","2016","1009435","45669","22031","2.183","20.078","5447","9.018","4435","7.343","60907","3065","3110","17133","41527","81842","123369","12.222","4.114","73795","101338","27543","10.039","2.729"
"California","2017","1018685","45771","14738","1.447","23.266","5220","8.56","4699","7.706","61242","3086","3181","18229","39656","93586","133242","13.08","3.893","82547","118504","35957","11.633","3.53"
"California","2018","1032493","45821","15456","1.497","20.143","4857","7.938","4518","7.384","61356","3306","3425","19374","33312","86132","119444","11.569","3.226","74355","103988","29633","10.072","2.87"
"Colorado","1978","6908830","388167","690597","9.996","31.39","83583","18.506","56123","12.426","465390","37511","38060","220386","673848","1101091","1774939","25.691","9.753","608994","1084342","475348","15.695","6.88"
"Colorado","1979","7581633","409260","658611","8.687","29.589","82180","17.278","52963","11.135","490241","35007","35510","205178","638411","1141876","1780287","23.482","8.42","681160","1121676","440516","14.795","5.81"
"Colorado","1980","8005135","417693","225961","2.823","34.621","78324","15.855","60190","12.184","503069","41632","42318","249960","647919","963772","1611691","20.133","8.094","881741","1385730","503989","17.311","6.296"
"Colorado","1981","8178273","429111","153043","1.871","33.713","76452","15.058","56264","11.082","517803","36077","36849","203656","590584","941024","1531608","18.728","7.221","946111","1378565","432454","16.856","5.288"
"Colorado","1982","8265045","428293","75678","0.916","36.477","76261","14.781","66837","12.955","520646","45757","46490","252997","650563","932522","1583085","19.154","7.871","1017738","1507407","489669","18.238","5.925"
"Colorado","1983","8185239","438923","80807","0.987","36.654","75505","14.486","55207","10.592","531364","36050","36838","229806","574920","1005977","1580897","19.314","7.024","1040088","1500090","460002","18.327","5.62"
"Colorado","1984","8532362","461614","793805","9.303","27.605","85537","15.854","52966","9.817","555826","36405","37140","219166","705365","1266106","1971471","23.106","8.267","782569","1177666","395097","13.802","4.631"
"Colorado","1985","9058142","475896","465475","5.139","33.029","87509","15.679","63839","11.438","569973","44699","45603","316213","728648","1232736","1961384","21.653","8.044","936184","1495909","559725","16.515","6.179"
"Colorado","1986","9358108","485992","443924","4.744","33.678","89640","15.676","63337","11.076","584988","44001","44809","284392","802749","1217000","2019749","21.583","8.578","1064574","1575825","511251","16.839","5.463"
"Colorado","1987","9806561","499970","336013","3.426","37.746","95279","16.161","68248","11.576","603068","46507","47486","321078","872760","1314056","2186816","22.3","8.9","1223463","1850803","627340","18.873","6.397"
"Colorado","1988","10199051","517463","416873","4.087","35.046","95114","15.475","68434","11.134","627986","47522","48607","337018","827887","1376179","2204066","21.611","8.117","1166843","1787193","620350","17.523","6.082"
"Colorado","1989","10578460","528706","484867","4.584","31.878","94982","15.039","69301","10.973","644424","48868","50155","334073","799169","1371815","2170984","20.523","7.555","1105338","1686117","580779","15.939","5.49"
"Colorado","1990","11042136","542302","491135","4.448","30.86","94666","14.582","69485","10.703","661805","50313","51586","351976","807137","1387826","2194963","19.878","7.31","1119678","1703828","584150","15.43","5.29"
"Colorado","1991","11019024","539838","-381950","-3.466","32.997","92231","13.983","77080","11.686","667149","55181","56498","450920","753103","1064847","1817950","16.498","6.835","1495495","2199900","704405","19.965","6.393"
"Colorado","1992","10614901","532548","-267777","-2.523","34.146","82513","12.533","79099","12.014","660089","53190","54575","404643","660092","1152164","1812256","17.073","6.219","1344792","2080033","735241","19.595","6.926"
"Colorado","1993","10499266","526945","-103960","-0.99","34.52","76433","11.692","84555","12.934","649682","54478","56024","348016","601224","1210943","1812167","17.26","5.726","1202620","1916127","713507","18.25","6.796"
"Colorado","1994","10436806","527616","24417","0.234","34.515","81244","12.503","79806","12.282","650515","52673","54490","364733","708034","1117539","1825573","17.492","6.784","1151787","1801156","649369","17.258","6.222"
"Colorado","1995","10578185","532357","283431","2.679","29.78","82731","12.674","74332","11.387","656981","50332","52023","316885","663176","1195338","1858514","17.569","6.269","1014787","1575083","560296","14.89","5.297"
"Colorado","1996","10753607","537533","196579","1.828","31.635","83715","12.729","72863","11.079","663094","49465","51059","329707","668065","1229462","1897527","17.645","6.212","1084919","1700948","616029","15.817","5.729"
"Colorado","1997","11070002","543194","389729","3.521","33.411","87187","13.118","80651","12.135","667890","50400","52290","355608","805420","1433601","2239021","20.226","7.276","1124761","1849292","724531","16.705","6.545"
"Colorado","1998","11643003","554143","490138","4.21","29.657","84525","12.523","71854","10.646","681297","45643","46858","310285","735907","1480708","2216615","19.038","6.321","1092469","1726477","634008","14.828","5.445"
"Colorado","1999","12024842","561686","241165","2.006","31.85","84495","12.331","72809","10.625","691079","45798","47378","343390","761124","1395000","2156124","17.931","6.33","1207537","1914959","707422","15.925","5.883"
"Colorado","2000","12417141","569684","498748","4.017","30.029","84128","12.098","72089","10.366","701434","45342","47122","314415","790292","1572805","2363097","19.031","6.365","1155699","1864349","708650","15.014","5.707"
"Colorado","2001","12794874","575392","304466","2.38","30.727","86510","12.261","75004","10.63","711343","48040","49527","344037","778103","1492127","2270230","17.743","6.081","1280092","1965764","685672","15.364","5.359"
"Colorado","2002","12832448","578723","-424549","-3.308","35.624","94957","13.261","85128","11.888","720990","53138","55043","483486","922727","1362991","2285718","17.812","7.191","1786485","2710267","923782","21.12","7.199"
"Colorado","2003","12688864","587503","159906","1.26","32.718","90021","12.426","79684","10.999","729620","50627","52306","352660","757210","1478476","2235686","17.619","5.968","1381977","2075780","693803","16.359","5.468"
"Colorado","2004","12862909","595371","190453","1.481","30.314","89180","12.159","79408","10.827","738329","51231","52771","358454","719153","1420913","2140066","16.637","5.591","1240948","1949613","708665","15.157","5.509"
"Colorado","2005","13073817","607480","173443","1.327","29.442","96960","12.999","79540","10.664","754599","53608","54919","346704","769289","1328737","2098026","16.048","5.884","1303567","1924583","621016","14.721","4.75"
"Colorado","2006","13460043","625061","509023","3.782","27.751","111144","14.505","84800","11.067","779399","60889","61953","373345","905679","1470977","2376656","17.657","6.729","1224191","1867633","643442","13.875","4.78"
"Colorado","2007","13712694","633052","1171","0.009","31.768","100052","12.759","86295","11.005","791042","56173","57251","351001","751419","1427909","2179328","15.893","5.48","1469509","2178157","708648","15.884","5.168"
"Colorado","2008","13592517","626773","-115633","-0.851","29.474","87508","11.111","90989","11.553","785847","60497","61655","372534","655765","1347357","2003122","14.737","4.824","1420550","2118755","698205","15.588","5.137"
"Colorado","2009","13168352","610271","-864280","-6.563","23.564","78187","10.055","96943","12.467","768227","63112","64550","391568","579987","971531","1551518","11.782","4.404","1719331","2415798","696467","18.345","5.289"
"Colorado","2010","12535396","598927","-392239","-3.129","24.466","77204","10.134","87263","11.454","756795","54919","56267","302415","537472","995963","1533435","12.233","4.288","1332263","1925674","593411","15.362","4.734"
"Colorado","2011","12440046","599746","211325","1.699","24.482","82304","10.867","78293","10.337","759404","49847","51191","264762","546393","1187697","1734090","13.94","4.392","1001239","1522765","521526","12.241","4.192"
"Colorado","2012","12672493","608205","276614","2.183","24.855","84615","11.098","74686","9.796","767374","45496","46641","259763","542977","1308542","1851519","14.611","4.285","1050855","1574905","524050","12.428","4.135"
"Colorado","2013","13009569","614222","429149","3.299","23.578","84010","10.919","75714","9.841","773543","47037","47898","270811","633932","1328883","1962815","15.087","4.873","990533","1533666","543133","11.789","4.175"
"Colorado","2014","13400335","625384","400444","2.988","23.661","87774","11.245","71304","9.135","788780","46954","47858","265328","651334","1334421","1985755","14.819","4.861","1055263","1585311","530048","11.83","3.955"
"Colorado","2015","13834059","635579","476282","3.443","22.217","88785","11.165","72913","9.169","803128","48698","49599","293117","674620","1338447","2013067","14.552","4.877","1022785","1536785","514000","11.109","3.715"
"Colorado","2016","14198321","647486","331884","2.337","23.931","91200","11.247","73388","9.05","819785","50908","51920","311536","644426","1386350","2030776","14.303","4.539","1067609","1698892","631283","11.965","4.446"
"Colorado","2017","14489378","655520","342967","2.367","24.889","89150","10.824","78630","9.547","828908","53714","54931","335526","660952","1485170","2146122","14.812","4.562","1188656","1803155","614499","12.445","4.241"
"Colorado","2018","14858030","664454","369131","2.484","22.072","86406","10.383","76990","9.252","836870","57934","59554","339032","643240","1365617","2008857","13.52","4.329","1111414","1639726","528312","11.036","3.556"
"Delaware","1978","856993","55138","110798","12.929","30.007","12341","19.801","8605","13.807","64192","5921","6004","29345","88424","150952","239376","27.932","10.318","70883","128578","57695","15.003","6.732"
"Delaware","1979","958466","58322","89295","9.316","29.726","11899","18.138","7807","11.9","67650","5226","5296","29163","85417","146336","231753","24.18","8.912","83681","142458","58777","14.863","6.132"
"Delaware","1980","1023356","59565","36734","3.59","34.315","11399","16.739","8783","12.897","69408","6169","6277","42594","84412","127904","212316","20.747","8.249","106782","175582","68800","17.157","6.723"
"Delaware","1981","1059402","61181","39924","3.769","34.798","11465","16.352","8219","11.723","71736","5632","5715","33135","90470","133778","224248","21.167","8.54","123702","184324","60622","17.399","5.722"
"Delaware","1982","1094917","62496","35686","3.259","36.53","12418","17.164","9490","13.117","73812","6701","6777","37850","95464","140207","235671","21.524","8.719","129940","199985","70045","18.265","6.397"
"Delaware","1983","1112410","64842","10009","0.9","39.546","12301","16.512","8352","11.211","76472","5788","5870","35044","100602","129364","229966","20.673","9.044","159754","219957","60203","19.773","5.412"
"Delaware","1984","1141837","68424","79757","6.985","30.386","13633","17.514","8354","10.732","80480","6119","6201","32852","102259","150975","253234","22.178","8.956","116282","173477","57195","15.193","5.009"
"Delaware","1985","1194081","69586","49528","4.148","34.236","13339","16.611","10389","12.937","81777","7637","7799","51362","95239","158694","253933","21.266","7.976","125748","204405","78657","17.118","6.587"
"Delaware","1986","1208994","69393","19213","1.589","36.043","12874","15.891","10565","13.041","82167","7616","7731","48863","101378","135714","237092","19.611","8.385","139733","217879","78146","18.022","6.464"
"Delaware","1987","1206490","69241","-35208","-2.918","39.533","12973","15.923","11218","13.769","82353","7736","7921","50099","110845","127635","238480","19.766","9.187","178402","273688","95286","22.685","7.898"
"Delaware","1988","1195927","70292","20020","1.674","36.003","12847","15.469","10612","12.778","84167","7611","7729","45701","100568","134736","235304","19.675","8.409","132049","215284","83235","18.001","6.96"
"Delaware","1989","1209722","70820","31477","2.602","32.995","12170","14.541","10011","11.962","84773","7096","7322","47664","89039","142013","231052","19.1","7.36","114292","199575","85283","16.498","7.05"
"Delaware","1990","1240434","72344","48702","3.926","29.774","12027","14.147","8973","10.555","86539","6480","6623","39969","91156","142211","233367","18.813","7.349","118586","184665","66079","14.887","5.327"
"Delaware","1991","1274437","73784","29420","2.308","31.404","12714","14.607","9112","10.469","88839","6433","6587","44686","91899","137635","229534","18.011","7.211","127467","200114","72647","15.702","5.7"
"Delaware","1992","1304860","75520","57651","4.418","30.282","12446","13.97","9249","10.381","90690","6097","6240","40965","98345","156873","255218","19.559","7.537","124933","197567","72634","15.141","5.566"
"Delaware","1993","1364676","79440","63180","4.63","28.952","13264","14.36","9368","10.142","94318","6040","6173","33351","88505","172228","260733","19.106","6.485","124952","197553","72601","14.476","5.32"
"Delaware","1994","1430889","83504","62900","4.396","29.0","14496","14.988","9594","9.919","99170","6734","6874","43664","101729","168652","270381","18.896","7.109","129040","207481","78441","14.5","5.482"
"Delaware","1995","1505480","87365","95062","6.314","27.853","15024","14.823","10085","9.95","103828","7093","7200","44066","120072","184647","304719","20.241","7.976","135979","209657","73678","13.926","4.894"
"Delaware","1996","1553116","89545","37222","2.397","33.324","14716","14.047","11435","10.915","106404","7815","7960","54746","119221","176782","296003","19.059","7.676","155334","258781","103447","16.662","6.661"
"Delaware","1997","1615545","91879","67289","4.165","33.199","15801","14.656","12486","11.581","109472","8217","8372","51624","134710","200754","335464","20.765","8.338","161804","268175","106371","16.6","6.584"
"Delaware","1998","1713858","94583","92073","5.372","29.533","15699","14.094","12005","10.778","113232","8010","8115","45238","127161","217992","345153","20.139","7.42","162914","253080","90166","14.767","5.261"
"Delaware","1999","1792634","96535","63358","3.534","32.255","15628","13.647","12394","10.823","116130","8174","8425","52110","136812","215649","352461","19.662","7.632","177100","289103","112003","16.127","6.248"
"Delaware","2000","1866740","98394","77888","4.172","30.725","15628","13.339","12959","11.061","118492","8138","8444","51280","132020","232644","364664","19.535","7.072","170440","286776","116336","15.362","6.232"
"Delaware","2001","1944244","100209","72822","3.746","32.418","16547","13.816","13239","11.054","121425","8589","8795","54422","145947","242014","387961","19.954","7.507","201610","315139","113529","16.209","5.839"
"Delaware","2002","1952131","100773","-79536","-4.074","34.792","16597","13.601","15371","12.596","122644","9310","9562","66255","136230","203364","339594","17.396","6.979","279063","419130","140067","21.47","7.175"
"Delaware","2003","1901518","102329","-18047","-0.949","33.032","16506","13.379","14482","11.739","124382","8904","9050","54256","120257","193797","314054","16.516","6.324","216269","332101","115832","17.465","6.092"
"Delaware","2004","1900323","104056","21163","1.114","29.747","16430","13.104","14099","11.245","126544","8979","9127","50816","115142","188664","303806","15.987","6.059","179764","282643","102879","14.873","5.414"
"Delaware","2005","1923833","106938","19391","1.008","29.172","17782","13.87","14144","11.032","130028","9084","9233","48695","114681","185321","300002","15.594","5.961","184856","280611","95755","14.586","4.977"
"Delaware","2006","1975199","110031","83534","4.229","27.265","20087","15.206","15505","11.738","134387","10532","10675","56504","142043","210764","352807","17.862","7.191","168010","269273","101263","13.633","5.127"
"Delaware","2007","2038596","112062","38079","1.868","31.35","18863","13.897","15449","11.382","137439","9801","9911","52030","132296","225334","357630","17.543","6.49","211922","319551","107629","15.675","5.28"
"Delaware","2008","2070747","111771","27299","1.318","29.694","16717","12.172","16331","11.891","137532","10574","10727","56052","112896","221850","334746","16.165","5.452","197922","307447","109525","14.847","5.289"
"Delaware","2009","2042159","108759","-95110","-4.657","25.773","14604","10.731","17978","13.21","134411","11296","11510","58080","100322","162838","263160","12.886","4.913","252888","358270","105382","17.544","5.16"
"Delaware","2010","1975338","106780","-41743","-2.113","26.89","14805","11.106","16456","12.344","132485","10006","10197","47558","97615","167970","265585","13.445","4.942","214018","307328","93310","15.558","4.724"
"Delaware","2011","1967587","106482","26223","1.333","25.9","15225","11.5","14887","11.244","132566","9205","9356","43316","90055","190971","281026","14.283","4.577","172565","254803","82238","12.95","4.18"
"Delaware","2012","2004855","107469","50036","2.496","24.228","14991","11.29","13895","10.465","133328","8163","8353","41167","92976","199928","292904","14.61","4.638","156950","242868","85918","12.114","4.285"
"Delaware","2013","2062125","109001","64697","3.137","23.404","15424","11.508","13367","9.973","135059","8170","8259","43055","95640","210365","306005","14.839","4.638","157004","241308","84304","11.702","4.088"
"Delaware","2014","2134252","111078","84992","3.982","22.677","16069","11.778","12871","9.434","138035","8300","8373","40430","108707","218275","326982","15.321","5.093","163591","241990","78399","11.338","3.673"
"Delaware","2015","2210476","113273","85472","3.867","22.018","16628","11.934","13489","9.681","140908","8644","8743","44859","106945","221882","328827","14.876","4.838","158605","243355","84750","11.009","3.834"
"Delaware","2016","2282296","115927","59931","2.626","22.926","17454","12.22","13189","9.234","144960","8824","8974","47155","117354","204195","321549","14.089","5.142","175135","261618","86483","11.463","3.789"
"Delaware","2017","2340950","118087","52634","2.248","24.754","16884","11.563","14255","9.762","147335","9254","9395","51018","117891","224482","342373","14.625","5.036","187709","289739","102030","12.377","4.358"
"Delaware","2018","2395171","120207","57137","2.386","22.361","16298","10.995","14058","9.484","149354","10298","10511","55905","105187","219738","324925","13.566","4.392","177544","267788","90244","11.18","3.768"
"District of Columbia","1978","1130753","56201","54306","4.803","26.041","8053","12.812","5932","9.437","63917","3965","4016","20260","59910","141627","201537","17.823","5.298","91741","147231","55490","13.021","4.907"
"District of Columbia","1979","1196934","58003","80948","6.763","20.544","7818","12.078","5248","8.108","66014","3428","3446","18408","65609","138289","203898","17.035","5.481","76442","122950","46508","10.272","3.886"
"District of Columbia","1980","1253706","58160","34839","2.779","23.811","7309","11.07","6243","9.456","66558","4153","4218","21082","62077","122020","184097","14.684","4.951","100571","149258","48687","11.905","3.883"
"District of Columbia","1981","1273488","59014","11100","0.872","25.461","7223","10.804","5616","8.4","67659","3475","3531","16177","66301","106919","173220","13.602","5.206","111423","162120","50697","12.73","3.981"
"District of Columbia","1982","1280235","59300","6191","0.484","27.15","7618","11.256","6540","9.663","68219","4493","4579","22238","66575","113407","179982","14.059","5.2","127194","173791","46597","13.575","3.64"
"District of Columbia","1983","1278171","60781","13280","1.039","26.751","7952","11.6","5386","7.857","69836","3674","3718","18764","61950","122294","184244","14.415","4.847","126666","170964","44298","13.376","3.466"
"District of Columbia","1984","1324325","63481","71978","5.435","23.064","8952","12.618","5227","7.368","72806","3761","3814","21382","73738","150960","224698","16.967","5.568","108208","152720","44512","11.532","3.361"
"District of Columbia","1985","1381168","64954","52101","3.772","24.968","9211","12.586","6635","9.066","74472","4853","4913","33425","71887","152641","224528","16.256","5.205","107492","172427","64935","12.484","4.701"
"District of Columbia","1986","1416930","66681","35939","2.536","26.017","9624","12.849","6632","8.854","76399","4668","4732","27298","81951","138307","220258","15.545","5.784","130889","184319","53430","13.008","3.771"
"District of Columbia","1987","1464105","68951","11534","0.788","33.195","11153","14.415","7362","9.515","79266","5257","5298","36098","95469","159067","254536","17.385","6.521","175513","243002","67489","16.597","4.61"
"District of Columbia","1988","1489084","71848","44215","2.969","30.151","11419","14.093","7443","9.186","83013","5313","5367","31135","112324","156377","268701","18.045","7.543","148812","224486","75674","15.075","5.082"
"District of Columbia","1989","1509699","72997","16351","1.083","29.024","10762","12.924","8260","9.919","84525","6048","6127","36017","89232","146204","235436","15.595","5.911","143170","219085","75915","14.512","5.028"
"District of Columbia","1990","1495509","72310","-5382","-0.36","28.145","9390","11.191","8718","10.39","84241","6516","6629","37776","78303","132153","210456","14.073","5.236","151149","215838","64689","14.432","4.326"
"District of Columbia","1991","1457979","69675","-47264","-3.242","28.01","8462","10.244","9454","11.445","82109","6898","7020","43984","71579","132610","204189","14.005","4.909","176344","251453","75109","17.247","5.152"
"District of Columbia","1992","1410288","68130","-9173","-0.65","28.062","8061","9.985","8458","10.477","80533","5667","5783","31930","67966","129913","197879","14.031","4.819","146027","207052","61025","14.682","4.327"
"District of Columbia","1993","1400477","68357","-16417","-1.172","28.622","8055","10.013","7807","9.704","80572","5156","5256","30031","59603","140819","200422","14.311","4.256","154155","216839","62684","15.483","4.476"
"District of Columbia","1994","1382866","68770","-17273","-1.249","28.313","8231","10.179","7604","9.403","81178","5210","5317","33668","65083","130680","195763","14.156","4.706","140599","213036","72437","15.405","5.238"
"District of Columbia","1995","1382327","69774","22943","1.66","25.581","8653","10.593","7230","8.851","82395","4935","5130","28046","76178","123571","199749","14.45","5.511","120918","176806","55888","12.79","4.043"
"District of Columbia","1996","1392112","69530","3725","0.268","28.041","8053","9.809","7515","9.153","82371","5049","5229","31663","76766","122137","198903","14.288","5.514","127970","195178","67208","14.02","4.828"
"District of Columbia","1997","1435516","69559","54661","3.808","28.132","8542","10.372","8223","9.985","82512","5248","5411","35613","90941","165640","256581","17.874","6.335","125369","201920","76551","14.066","5.333"
"District of Columbia","1998","1476860","69787","11299","0.765","29.121","8008","9.68","7647","9.244","82907","4825","4936","27852","79037","147300","226337","15.326","5.352","141585","215038","73453","14.56","4.974"
"District of Columbia","1999","1500721","69620","35079","2.337","25.832","7751","9.348","7324","8.833","83131","4741","4880","29434","76415","152495","228910","15.253","5.092","123297","193831","70534","12.916","4.7"
"District of Columbia","2000","1531019","69755","16962","1.108","26.062","7564","9.099","7255","8.727","83284","4501","4675","29023","72143","144324","216467","14.139","4.712","128240","199505","71265","13.031","4.655"
"District of Columbia","2001","1543340","69233","8215","0.532","27.291","7743","9.313","7462","8.975","83278","4589","4736","27579","80061","138748","218809","14.178","5.188","138223","210594","72371","13.645","4.689"
"District of Columbia","2002","1546272","68691","-19381","-1.253","30.472","8304","9.987","8277","9.955","83161","4986","5076","36372","89663","145927","235590","15.236","5.799","168949","254971","86022","16.489","5.563"
"District of Columbia","2003","1537570","68275","668","0.043","28.072","7410","8.95","7861","9.495","82565","4700","4772","27731","66410","150074","216484","14.08","4.319","146549","215816","69267","14.036","4.505"
"District of Columbia","2004","1533358","68863","-961","-0.063","26.51","7952","9.581","6956","8.381","83498","4387","4445","24653","67308","135942","203250","13.255","4.39","136831","204211","67380","13.318","4.394"
"District of Columbia","2005","1527674","69261","-5602","-0.367","24.245","8219","9.813","7502","8.957","84118","4632","4696","27169","73006","112190","185196","12.123","4.779","131354","190798","59444","12.489","3.891"
"District of Columbia","2006","1532952","69428","25739","1.679","23.786","8883","10.511","7812","9.244","85047","5329","5431","29629","75333","132717","208050","13.572","4.914","119390","182311","62921","11.893","4.105"
"District of Columbia","2007","1534609","68935","-23408","-1.525","26.994","8190","9.635","7953","9.357","85117","4974","5058","30678","73171","133952","207123","13.497","4.768","167266","230531","63265","15.022","4.123"
"District of Columbia","2008","1527802","68137","7797","0.51","27.36","7502","8.846","7885","9.298","84613","5036","5105","26135","68803","148001","216804","14.191","4.503","149718","209007","59289","13.68","3.881"
"District of Columbia","2009","1497875","66252","-81188","-5.42","19.803","6279","7.506","8494","10.154","82544","5161","5243","31848","48128","100184","148312","9.901","3.213","168409","229500","61091","15.322","4.079"
"District of Columbia","2010","1441970","65077","-28513","-1.977","21.282","6520","7.963","7600","9.282","81335","4577","4679","24456","50210","103228","153438","10.641","3.482","132912","181951","49039","12.618","3.401"
"District of Columbia","2011","1429801","64216","6331","0.443","21.541","6466","7.997","7191","8.894","80493","4430","4503","22593","48077","112251","160328","11.213","3.362","106091","153997","47906","10.771","3.351"
"District of Columbia","2012","1445388","64468","24920","1.724","21.526","7004","8.694","6553","8.134","80788","3878","3948","20918","49312","131175","180487","12.487","3.412","108329","155567","47238","10.763","3.268"
"District of Columbia","2013","1457765","64242","1472","0.101","21.833","6887","8.541","6789","8.419","80687","4083","4142","21425","47540","113071","160611","11.018","3.261","108882","159139","50257","10.917","3.448"
"District of Columbia","2014","1468447","64079","18135","1.235","20.455","6847","8.477","6502","8.05","80947","4111","4151","19723","50948","117369","168317","11.462","3.47","101375","150182","48807","10.227","3.324"
"District of Columbia","2015","1489695","63858","18190","1.221","21.211","6793","8.391","6577","8.124","81066","4075","4134","23567","58408","117775","176183","11.827","3.921","112729","157993","45264","10.606","3.038"
"District of Columbia","2016","1518531","64567","41144","2.709","18.84","7711","9.432","6170","7.547","82525","4098","4147","19947","60877","123315","184192","12.13","4.009","96175","143048","46873","9.42","3.087"
"District of Columbia","2017","1526950","63684","2495","0.163","23.756","6231","7.597","7014","8.551","81632","4448","4549","33823","58222","125643","183865","12.041","3.813","106280","181370","75090","11.878","4.918"
"District of Columbia","2018","1526640","63238","278","0.018","22.569","6397","7.874","6832","8.409","81025","4644","4755","30125","56039","116512","172551","11.303","3.671","118252","172273","54021","11.284","3.539"
"Florida","1978","214404","9940","8821","4.114","28.1","1531","13.513","1208","10.662","11491","814","826","5055","11727","27218","38945","18.164","5.47","20163","30124","9961","14.05","4.646"
"Florida","1979","206346","10291","7813","3.786","24.029","1559","13.389","1070","9.19","11888","690","707","3425","11836","20768","32604","15.801","5.736","16307","24791","8484","12.014","4.112"
"Florida","1980","213274","10292","5615","2.633","24.559","1356","11.452","1249","10.549","11894","880","911","3707","11260","20544","31804","14.912","5.28","18796","26189","7393","12.28","3.466"
"Florida","1981","218050","10301","5790","2.655","24.1","1273","10.713","1129","9.501","11955","703","719","2990","11478","20587","32065","14.705","5.264","19021","26275","7254","12.05","3.327"
"Florida","1982","221679","10340","1952","0.881","27.089","1394","11.709","1249","10.491","11978","828","846","4327","12620","19357","31977","14.425","5.693","21154","30025","8871","13.544","4.002"
"Florida","1983","222427","10802","6958","3.128","25.485","1671","13.764","975","8.031","12488","635","644","3475","12869","22432","35301","15.871","5.786","21770","28343","6573","12.743","2.955"
"Florida","1984","232049","11181","17003","7.327","21.527","1726","13.708","1085","8.617","12912","766","771","3588","15039","26941","41980","18.091","6.481","18623","24977","6354","10.764","2.738"
"Florida","1985","257668","11496","37301","14.476","24.788","1786","13.761","1237","9.531","13253","834","851","5291","36496","32740","69236","26.87","14.164","20851","31935","11084","12.394","4.302"
"Florida","1986","279075","11985","9343","3.348","27.11","2007","14.935","1172","8.721","13856","812","824","4130","15795","31376","47171","16.903","5.66","27418","37828","10410","13.555","3.73"
"Florida","1987","288740","12387","-19073","-6.606","37.875","2157","15.409","1380","9.858","14387","933","942","6307","18158","36522","54680","18.937","6.289","25031","73753","13110","25.543","4.54"
"Florida","1988","287157","13038","18116","6.309","27.078","2233","15.132","1371","9.291","15188","938","959","6566","22078","34916","56994","19.848","7.688","26892","38878","11986","13.539","4.174"
"Florida","1989","302008","13600","10774","3.567","28.046","2320","14.996","1384","8.946","15939","957","983","6931","19527","33597","53124","17.59","6.466","29689","42350","12661","14.023","4.192"
"Florida","1990","309853","14103","11555","3.729","24.07","2271","14.039","1461","9.032","16581","1059","1069","5951","15519","33326","48845","15.764","5.009","27410","37290","9880","12.035","3.189"
"Florida","1991","316850","14266","1575","0.497","29.016","2320","13.887","1645","9.846","17044","1110","1141","6376","19331","28212","47543","15.005","6.101","35626","45968","10342","14.508","3.264"
"Florida","1992","309164","14297","-3048","-0.986","29.261","2203","12.991","1776","10.473","17172","1124","1133","6484","19060","26172","45232","14.63","6.165","34689","48280","13591","15.616","4.396"
"Florida","1993","308441","14691","3268","1.06","28.275","2107","12.176","1759","10.165","17479","1048","1068","5958","15826","31048","46874","15.197","5.131","29468","43606","14138","14.138","4.584"
"Florida","1994","312919","15012","4817","1.539","29.2","2302","13.005","1832","10.35","17936","1159","1169","7601","19931","30572","50503","16.139","6.369","30776","45686","14910","14.6","4.765"
"Florida","1995","322784","15478","17046","5.281","25.361","2386","13.111","1773","9.743","18505","1148","1172","6512","20236","37741","57977","17.962","6.269","25775","40931","15156","12.681","4.695"
"Florida","1996","330399","15642","3004","0.909","27.573","2194","11.861","1836","9.925","18677","1174","1210","6857","18624","29931","48555","14.696","5.637","30598","45551","14953","13.787","4.526"
"Florida","1997","341543","15994","11705","3.427","28.624","2454","12.995","1977","10.469","19122","1241","1257","8033","21652","38934","60586","17.739","6.339","31326","48881","17555","14.312","5.14"
"Florida","1998","351840","16473","7215","2.051","30.787","2448","12.568","1986","10.196","19709","1187","1202","7402","22504","38872","61376","17.444","6.396","35144","54161","19017","15.394","5.405"
"Florida","1999","359489","16861","9474","2.635","30.242","2464","12.384","2002","10.062","20128","1191","1220","8024","29438","34394","63832","17.756","8.189","34768","54358","19590","15.121","5.449"
"Florida","2000","370558","17282","13060","3.524","31.073","2708","13.261","2077","10.171","20736","1243","1268","6652","31059","39573","70632","19.061","8.382","32826","57572","24746","15.537","6.678"
"Florida","2001","382242","17636","8974","2.348","29.488","2630","12.537","2035","9.701","21275","1237","1268","7287","25516","39816","65332","17.092","6.675","38633","56358","17725","14.744","4.637"
"Florida","2002","386240","17535","-4305","-1.115","33.824","2689","12.543","2407","11.228","21579","1418","1476","10117","30870","34451","65321","16.912","7.992","45760","69626","23866","18.027","6.179"
"Florida","2003","382343","17789","-2559","-0.669","26.93","2415","11.134","2050","9.452","21872","1229","1252","7254","17780","33702","51482","13.465","4.65","35604","54041","18437","14.134","4.822"
"Florida","2004","386182","18119","10202","2.642","26.106","2589","11.713","2029","9.179","22384","1250","1274","7299","23798","36813","60611","15.695","6.162","30577","50409","19832","13.053","5.135"
"Florida","2005","389944","18332","1126","0.289","27.49","2454","10.938","2283","10.176","22521","1316","1334","9274","18833","35891","54724","14.034","4.83","30821","53598","22777","13.745","5.841"
"Florida","2006","389303","18352","-2436","-0.626","28.359","2731","12.089","2530","11.199","22692","1729","1765","9367","20402","34799","55201","14.179","5.241","35279","57637","22358","14.805","5.743"
"Florida","2007","386896","18133","-2488","-0.643","33.286","2603","11.463","2494","10.983","22762","1452","1457","8394","27346","37045","64391","16.643","7.068","43180","66879","23699","17.286","6.125"
"Florida","2008","384822","17841","16","0.004","30.068","2263","10.021","2488","11.017","22471","1539","1552","7129","19294","38576","57870","15.038","5.014","41390","57854","16464","15.034","4.278"
"Florida","2009","376922","17374","-19045","-5.053","23.65","2003","9.002","2526","11.353","21989","1498","1534","7831","20817","23754","44571","11.825","5.523","45357","63616","18259","16.878","4.844"
"Florida","2010","363388","17154","-8104","-2.23","22.215","1948","8.937","2254","10.34","21645","1294","1318","5750","12373","27991","40364","11.108","3.405","33822","48468","14646","13.338","4.03"
"Florida","2011","359187","17036","-1033","-0.288","24.147","2020","9.361","2086","9.667","21545","1248","1272","5856","12691","30676","43367","12.074","3.533","30536","44400","13864","12.361","3.86"
"Florida","2012","359805","16917","2850","0.792","25.738","2109","9.802","2055","9.551","21544","1149","1187","5771","16369","32785","49154","13.661","4.549","28611","46304","17693","12.869","4.917"
"Florida","2013","366213","16962","10136","2.768","23.19","2070","9.613","1922","8.925","21608","1075","1087","5123","17656","34943","52599","14.363","4.821","27237","42463","15226","11.595","4.158"
"Florida","2014","381767","17098","10362","2.714","23.364","2069","9.555","1890","8.728","21744","1099","1121","5387","14781","40179","54960","14.396","3.872","31227","44598","13371","11.682","3.502"
"Florida","2015","391120","17294","8081","2.066","23.682","2225","10.181","1932","8.84","22002","1115","1135","6280","17591","36803","54394","13.907","4.498","31075","46313","15238","11.841","3.896"
"Florida","2016","398562","17723","7804","1.958","23.107","2376","10.647","1690","7.573","22659","1118","1137","6228","16514","37338","53852","13.512","4.143","33530","46048","12518","11.554","3.141"
"Florida","2017","399983","17809","-2544","-0.636","26.872","2229","9.839","2150","9.49","22695","1307","1326","6076","15936","37806","53742","13.436","3.984","36347","56286","19939","14.072","4.985"
"Florida","2018","411546","18068","23591","5.732","21.179","2278","9.982","1926","8.439","22998","1354","1380","6755","24925","42247","67172","16.322","6.056","31636","43581","11945","10.59","2.902"
"Georgia","1978","295496","12722","24573","8.316","28.438","1946","13.452","1681","11.62","14599","1019","1042","5566","18359","48230","66589","22.535","6.213","25308","42016","16708","14.219","5.654"
"Georgia","1979","315854","13015","26027","8.24","20.66","1870","12.765","1319","9.004","14925","843","858","5261","16521","42134","58655","18.57","5.231","20688","32628","11940","10.33","3.78"
"Georgia","1980","321445","12876","-13529","-4.209","31.594","1767","12.012","1588","10.795","14800","1001","1024","7581","15702","35076","50778","15.797","4.885","29757","64307","34550","20.006","10.748"
"Georgia","1981","317559","12948","7362","2.318","25.372","1702","11.54","1457","9.879","14871","890","903","5969","17544","30103","47647","15.004","5.525","26282","40285","14003","12.686","4.41"
"Georgia","1982","320980","13246","-3940","-1.227","33.758","2238","14.952","1695","11.325","15239","1128","1141","7777","25778","28400","54178","16.879","8.031","44958","58118","13160","18.106","4.1"
"Georgia","1983","319539","13836","18233","5.706","31.42","2259","14.68","1345","8.741","15845","885","897","6416","31750","36682","68432","21.416","9.936","38346","50199","11853","15.71","3.709"
"Georgia","1984","333789","13976","16329","4.892","26.352","2177","13.783","1638","10.371","16064","1146","1158","6123","22029","38280","60309","18.068","6.6","32607","43980","11373","13.176","3.407"
"Georgia","1985","349249","13895","23683","6.781","30.177","2078","13.04","1899","11.917","16025","1417","1438","11948","22197","54182","76379","21.87","6.356","31790","52696","20906","15.088","5.986"
"Georgia","1986","364526","14059","9947","2.729","27.205","2130","13.287","1497","9.338","16347","1037","1051","8529","23409","36122","59531","16.331","6.422","35602","49584","13982","13.602","3.836"
"Georgia","1987","377501","14169","20142","5.336","26.658","2126","13.053","1646","10.106","16527","1084","1101","8298","27037","43423","70460","18.665","7.162","33053","50318","17265","13.329","4.573"
"Georgia","1988","378198","14501","-9911","-2.621","32.235","2300","13.684","1621","9.645","17147","1103","1112","10986","21867","39089","60956","16.117","5.782","53573","70867","17294","18.738","4.573"
"Georgia","1989","377721","14518","13633","3.609","27.261","2211","12.881","1672","9.741","17434","1106","1112","8641","20776","44342","65118","17.24","5.5","31485","51485","20000","13.63","5.295"
"Georgia","1990","392329","14264","6973","1.777","25.973","2010","11.783","1603","9.397","17262","1052","1069","6957","20777","37145","57922","14.764","5.296","36943","50949","14006","12.986","3.57"
"Georgia","1991","385326","14210","-16660","-4.324","25.585","2124","12.419","1857","10.858","17236","1141","1174","10073","19840","29453","49293","12.793","5.149","48483","65953","17470","17.116","4.534"
"Georgia","1992","387237","14077","14093","3.639","27.726","1816","10.663","1631","9.577","17123","995","1002","6880","36290","31485","67775","17.502","9.372","40013","53682","13669","13.863","3.53"
"Georgia","1993","389822","14119","1720","0.441","27.901","1760","10.331","1821","10.689","17006","969","989","6957","18808","37294","56102","14.392","4.825","34806","54382","19576","13.95","5.022"
"Georgia","1994","391736","14293","5348","1.365","23.867","1848","10.791","1621","9.465","17239","1058","1092","8464","17637","34458","52095","13.299","4.502","31160","46747","15587","11.933","3.979"
"Georgia","1995","392737","14392","-3123","-0.795","26.56","1853","10.706","1620","9.36","17424","1015","1040","7624","16436","35719","52155","13.28","4.185","38014","55278","17264","14.075","4.396"
"Georgia","1996","373189","14370","-19785","-5.302","25.255","1836","10.576","1688","9.724","17434","1053","1084","7087","16889","30236","47125","12.628","4.526","50668","66910","16242","17.929","4.352"
"Georgia","1997","365108","14262","7161","1.961","27.636","1878","10.851","2034","11.752","17229","1146","1203","7146","20529","37082","57611","15.779","5.623","32372","50450","18078","13.818","4.951"
"Georgia","1998","381192","14364","6815","1.788","26.749","1805","10.414","1640","9.462","17415","906","934","6956","20164","37634","57798","15.162","5.29","34890","50983","16093","13.375","4.222"
"Georgia","1999","388084","14338","8082","2.083","25.387","1805","10.37","1706","9.801","17455","944","968","7429","21323","36020","57343","14.776","5.494","30945","49261","18316","12.693","4.72"
"Georgia","2000","398423","14395","13538","3.398","22.482","1768","10.09","1563","8.92","17624","872","880","5712","18587","39737","58324","14.639","4.665","32133","44786","12653","11.241","3.176"
"Georgia","2001","400501","14318","5389","1.346","27.713","1833","10.453","1593","9.085","17655","890","914","6759","21864","39020","60884","15.202","5.459","35308","55495","20187","13.856","5.04"
"Georgia","2002","413825","14641","149","0.036","32.679","2210","12.304","1966","10.946","18083","1009","1030","11039","25443","42323","67766","16.376","6.148","43981","67617","23636","16.34","5.712"
"Georgia","2003","412841","14615","6","0.001","26.64","1712","9.504","1706","9.471","18016","892","901","4801","17102","37895","54997","13.322","4.143","38014","54991","16977","13.32","4.112"
"Georgia","2004","417889","14658","4126","0.987","25.381","1892","10.462","1661","9.185","18200","939","971","5920","18993","38165","57158","13.678","4.545","38948","53032","14084","12.69","3.37"
"Georgia","2005","422001","14988","4463","1.058","24.02","2071","11.268","1624","8.836","18603","859","881","5661","19602","35544","55146","13.068","4.645","36703","50683","13980","12.01","3.313"
"Georgia","2006","429631","15312","7871","1.832","25.306","2284","12.113","1669","8.851","19164","973","984","6425","20892","41341","62233","14.485","4.863","38759","54362","15603","12.653","3.632"
"Georgia","2007","434175","15379","1478","0.34","31.553","2077","10.788","1782","9.255","19401","939","946","6546","21461","48515","69976","16.117","4.943","48967","68498","19531","15.777","4.498"
"Georgia","2008","438674","15364","8474","1.932","23.692","1957","10.089","1852","9.548","19449","893","919","4633","18979","41460","60439","13.778","4.326","36482","51965","15483","11.846","3.53"
"Georgia","2009","447228","15323","5526","1.236","25.544","2038","10.43","1903","9.739","19608","970","984","6015","20115","42530","62645","14.007","4.498","41966","57119","15153","12.772","3.388"
"Georgia","2010","460178","15411","521","0.113","23.955","2019","10.246","1702","8.638","19863","913","924","5202","18723","36916","55639","12.091","4.069","42304","55118","12814","11.978","2.785"
"Georgia","2011","466072","15575","11076","2.376","21.174","1935","9.709","1715","8.606","20039","836","844","5177","17054","43366","60420","12.964","3.659","35832","49344","13512","10.587","2.899"
"Georgia","2012","474637","15705","10051","2.118","23.358","1834","9.169","1780","8.899","20030","802","817","9728","17592","47891","65483","13.796","3.706","37541","55432","17891","11.679","3.769"
"Georgia","2013","482665","15916","6912","1.432","20.931","2172","10.751","1692","8.375","20443","839","846","5976","19282","38144","57426","11.898","3.995","34783","50514","15731","10.466","3.259"
"Georgia","2014","489150","16077","7292","1.491","21.562","2000","9.732","1674","8.146","20713","900","914","5774","20402","39626","60028","12.272","4.171","38521","52736","14215","10.781","2.906"
"Georgia","2015","498982","16296","14829","2.972","23.625","2182","10.497","1896","9.121","20930","940","953","7171","26881","46890","73771","14.784","5.387","41128","58942","17814","11.812","3.57"
"Georgia","2016","512071","16565","12272","2.397","20.411","2276","10.714","1592","7.494","21586","965","988","5441","20196","44336","64532","12.602","3.944","40378","52260","11882","10.206","2.32"
"Georgia","2017","521179","16692","7059","1.354","21.155","1987","9.175","1754","8.099","21774","1014","1025","6866","18212","43974","62186","11.932","3.494","35706","55127","19421","10.577","3.726"
"Georgia","2018","531213","16890","14597","2.748","18.805","1957","8.974","1803","8.268","21884","1101","1128","7518","21938","42607","64545","12.15","4.13","35028","49948","14920","9.403","2.809"
"Hawaii","1978","2517005","165134","250050","9.934","33.291","36378","19.028","25268","13.217","196733","17737","18027","100573","265577","403441","669018","26.58","10.551","228607","418968","190361","16.645","7.563"
"Hawaii","1979","2746866","173982","220487","8.027","31.464","35846","17.843","23322","11.609","207162","15743","15951","94662","255119","397511","652630","23.759","9.288","250793","432143","181350","15.732","6.602"
"Hawaii","1980","2916429","181584","130842","4.486","32.811","36271","17.209","24322","11.54","216744","17991","18267","106774","252041","357257","609298","20.892","8.642","305069","478456","173387","16.406","5.945"
"Hawaii","1981","3063567","190850","186683","6.094","30.981","37655","17.011","23417","10.579","228482","16101","16356","82336","273483","387765","661248","21.584","8.927","326850","474565","147715","15.491","4.822"
"Hawaii","1982","3172823","193445","34904","1.1","37.973","37076","16.151","29541","12.868","233332","21491","21745","118782","268748","368569","637317","20.087","8.47","404977","602413","197436","18.987","6.223"
"Hawaii","1983","3189368","203954","61870","1.94","35.845","40413","17.03","24537","10.34","245242","17345","17642","102101","265141","368339","633480","19.862","8.313","398404","571610","173206","17.922","5.431"
"Hawaii","1984","3366275","215873","338980","10.07","27.262","43824","17.518","26470","10.581","258846","19565","19860","103177","313682","484155","797837","23.701","9.318","295263","458857","163594","13.631","4.86"
"Hawaii","1985","3626845","224231","272249","7.506","31.963","46201","17.664","31365","11.992","268977","23315","23748","143489","346169","505708","851877","23.488","9.545","358667","579628","220961","15.982","6.092"
"Hawaii","1986","3821172","231059","217738","5.698","33.719","46834","17.335","31775","11.761","277694","23379","23762","148310","361522","500452","861974","22.558","9.461","415486","644236","228750","16.86","5.986"
"Hawaii","1987","4000641","239422","209462","5.236","36.372","50916","18.087","34786","12.357","289565","25168","25539","165956","438414","498600","937014","23.422","10.959","449315","727552","278237","18.186","6.955"
"Hawaii","1988","4211878","251501","212549","5.046","34.634","53176","17.889","35373","11.9","306159","26319","26823","171185","407791","534120","941911","22.363","9.682","446349","729362","283013","17.317","6.719"
"Hawaii","1989","4415005","258591","237965","5.39","32.851","51052","16.566","36793","11.939","315308","27092","27774","175120","387950","575201","963151","21.815","8.787","450859","725186","274327","16.425","6.214"
"Hawaii","1990","4600503","265517","144014","3.13","33.601","51170","16.097","37638","11.84","324643","28561","29318","179305","384179","532739","916918","19.931","8.351","501318","772904","271586","16.8","5.903"
"Hawaii","1991","4622617","265062","-51718","-1.119","37.264","49485","15.294","42043","12.994","327271","30556","31407","209870","388274","473008","861282","18.632","8.399","590284","913000","322716","19.751","6.981"
"Hawaii","1992","4570396","268933","61811","1.352","36.134","48481","14.855","39543","12.116","330834","27297","28024","177507","370437","517112","887549","19.42","8.105","513245","825738","312493","18.067","6.837"
"Hawaii","1993","4692449","278264","185904","3.962","33.031","50318","15.049","40631","12.151","339214","28154","28965","177057","371113","589764","960877","20.477","7.909","458175","774973","316798","16.515","6.751"
"Hawaii","1994","4894288","285095","203433","4.157","31.13","50655","14.761","41250","12.021","347860","30140","30862","185904","375669","589555","965224","19.721","7.676","467745","761791","294046","15.565","6.008"
"Hawaii","1995","5105950","290885","199406","3.905","32.117","50457","14.373","41624","11.857","355460","30448","31310","200583","430590","588759","1019349","19.964","8.433","505529","819943","314414","16.059","6.158"
"Hawaii","1996","5231708","294682","119091","2.276","33.978","50135","14.055","42484","11.91","360528","30664","31383","200264","405201","602701","1007902","19.265","7.745","544936","888811","343875","16.989","6.573"
"Hawaii","1997","5376361","297222","128742","2.395","36.287","52635","14.526","46295","12.777","365512","32307","33223","226931","441141","663048","1104189","20.538","8.205","561585","975447","413862","18.143","7.698"
"Hawaii","1998","5607652","301339","245519","4.378","32.972","50279","13.666","44865","12.195","370611","29658","30646","195982","461806","708200","1170006","20.864","8.235","539708","924487","384779","16.486","6.862"
"Hawaii","1999","5836672","303105","191408","3.279","34.034","50649","13.622","45139","12.14","374568","30244","31281","206564","411896","772735","1184631","20.296","7.057","589227","993223","403996","17.017","6.922"
"Hawaii","2000","6040869","303818","236768","3.919","31.772","48890","13.053","45816","12.232","376090","29692","30585","185895","415665","780762","1196427","19.806","6.881","545592","959659","414067","15.886","6.854"
"Hawaii","2001","6260039","307721","218393","3.489","34.416","52176","13.788","44705","11.814","382146","28514","29323","176851","477596","818011","1295607","20.696","7.629","648315","1077214","428899","17.208","6.851"
"Hawaii","2002","6352271","312930","-144209","-2.27","38.167","56529","14.659","47840","12.405","389984","30215","31112","253327","496282","715948","1212230","19.083","7.813","840467","1356439","515972","21.354","8.123"
"Hawaii","2003","6343574","322928","149378","2.355","33.963","58712","14.872","47240","11.966","400531","30780","31316","187740","445203","781411","1226614","19.336","7.018","650457","1077236","426779","16.982","6.728"
"Hawaii","2004","6549318","339257","130892","1.999","33.846","65388","15.975","46556","11.374","418722","30877","31622","203242","435789","803430","1239219","18.921","6.654","659680","1108327","448647","16.923","6.85"
"Hawaii","2005","6714808","354918","159272","2.372","31.794","68136","15.938","49420","11.56","436872","32593","33110","215033","483858","742868","1226726","18.269","7.206","676003","1067454","391451","15.897","5.83"
"Hawaii","2006","6973636","369696","365174","5.236","27.448","73224","16.427","53594","12.023","455582","37821","38355","218936","525720","796508","1322228","18.96","7.539","586187","957054","370867","13.724","5.318"
"Hawaii","2007","7182748","372844","-11870","-0.165","34.039","67381","14.708","59466","12.98","462078","40110","40753","241147","483674","738789","1222463","17.019","6.734","782258","1234333","452075","17.185","6.294"
"Hawaii","2008","7107836","360839","-162972","-2.293","29.912","56219","12.331","66805","14.653","450605","46066","46605","232090","401376","661672","1063048","14.956","5.647","797710","1226020","428310","17.249","6.026"
"Hawaii","2009","6798438","346432","-485461","-7.141","25.25","52266","11.776","67993","15.32","435961","44265","45060","216581","369716","488573","858289","12.625","5.438","945132","1343750","398618","19.766","5.863"
"Hawaii","2010","6505350","343501","-100136","-1.539","29.229","54146","12.485","56586","13.048","432461","36051","36723","175592","349641","601082","950723","14.614","5.375","694846","1050859","356013","16.154","5.473"
"Hawaii","2011","6517064","346122","119487","1.833","28.403","57203","13.188","52880","12.192","435903","34233","34986","168900","375136","669886","1045022","16.035","5.756","579489","925535","346046","14.202","5.31"
"Hawaii","2012","6694993","354863","235928","3.524","26.062","57636","13.098","46968","10.673","445379","29356","30105","203082","402028","706337","1108365","16.555","6.005","536195","872437","336242","13.031","5.022"
"Hawaii","2013","6938770","361051","180841","2.606","25.25","55616","12.413","47849","10.68","451921","30639","31078","158671","383235","673611","1056846","15.231","5.523","561048","876005","314957","12.625","4.539"
"Hawaii","2014","7154542","367107","256999","3.592","24.63","56889","12.478","47234","10.361","460724","31637","32173","170049","403864","734204","1138068","15.907","5.645","578205","881069","302864","12.315","4.233"
"Hawaii","2015","7448851","375203","322717","4.332","22.345","58804","12.628","47298","10.157","471431","31441","32079","177075","403101","751842","1154943","15.505","5.412","515130","832226","317096","11.173","4.257"
"Hawaii","2016","7737073","384631","232103","3.0","23.242","60647","12.684","45838","9.586","485561","32323","32797","174301","405379","725846","1131225","14.621","5.239","566711","899122","332411","11.621","4.296"
"Hawaii","2017","7888174","390921","208779","2.647","24.339","58165","11.912","50965","10.437","491893","34701","35229","191481","375335","793413","1168748","14.816","4.758","603698","959969","356271","12.17","4.517"
"Hawaii","2018","8088509","397533","263210","3.254","22.167","56922","11.511","50032","10.117","497966","37516","38419","190794","418117","741593","1159710","14.338","5.169","570773","896500","325727","11.084","4.027"
"Idaho","1978","1541846","82072","136359","8.844","28.894","16191","16.574","12174","12.462","99696","8039","8131","43174","136975","222132","359107","23.291","8.884","129778","222748","92970","14.447","6.03"
"Idaho","1979","1647520","84191","75744","4.597","29.46","15530","15.394","11694","11.592","102800","7612","7700","42015","125080","193344","318424","19.327","7.592","150365","242680","92315","14.73","5.603"
"Idaho","1980","1700907","84573","9429","0.554","31.379","14196","13.775","12105","11.746","104104","8421","8539","45189","111203","165092","276295","16.244","6.538","178551","266866","88315","15.69","5.192"
"Idaho","1981","1725252","86071","50608","2.933","29.611","14412","13.75","11193","10.679","106426","7308","7449","37784","121831","184209","306040","17.739","7.062","177821","255432","77611","14.805","4.499"
"Idaho","1982","1760162","85754","25202","1.432","32.335","14345","13.51","12929","12.177","106885","8844","8964","46242","133199","176575","309774","17.599","7.567","198336","284572","86236","16.167","4.899"
"Idaho","1983","1765055","89315","45197","2.561","31.042","15802","14.614","10250","9.479","110907","6812","6941","41162","114353","204800","319153","18.082","6.479","186317","273956","87639","15.521","4.965"
"Idaho","1984","1871804","95200","198989","10.631","22.564","18448","16.247","10350","9.115","117593","7220","7317","38823","154912","255250","410162","21.913","8.276","138057","211173","73116","11.282","3.906"
"Idaho","1985","2042579","99089","175348","8.585","26.841","18645","15.686","12516","10.53","121928","8688","8867","56765","167834","281639","449473","22.005","8.217","166827","274125","107298","13.421","5.253"
"Idaho","1986","2171421","101809","116003","5.342","29.191","19151","15.608","13034","10.623","125760","9006","9128","57381","168975","263963","432938","19.938","7.782","209474","316935","107461","14.596","4.949"
"Idaho","1987","2284326","104745","77181","3.379","35.067","20204","15.884","14157","11.13","130221","9483","9653","67163","213898","263804","477702","20.912","9.364","268369","400521","132152","17.533","5.785"
"Idaho","1988","2376537","109026","94008","3.956","31.787","21024","15.787","14259","10.707","136555","10003","10173","77412","202721","269006","471727","19.849","8.53","239965","377719","137754","15.894","5.796"
"Idaho","1989","2447538","111718","103387","4.224","32.259","20800","15.12","14966","10.879","140481","10564","10829","73328","204815","293346","498161","20.354","8.368","260743","394774","134031","16.129","5.476"
"Idaho","1990","2522060","113400","62318","2.471","31.259","19591","13.901","15249","10.82","143107","10956","11265","71785","169135","287373","456508","18.101","6.706","261138","394190","133052","15.63","5.276"
"Idaho","1991","2500986","112800","-75838","-3.032","32.276","19307","13.54","16659","11.683","143914","11470","11783","106166","173330","230278","403608","16.138","6.93","306276","479446","173170","19.17","6.924"
"Idaho","1992","2484676","114525","73463","2.957","30.83","19194","13.356","15596","10.852","145514","9969","10367","68521","172572","283910","456482","18.372","6.945","252452","383019","130567","15.415","5.255"
"Idaho","1993","2561811","118544","90333","3.526","28.785","19550","13.288","15417","10.479","149189","9951","10237","67010","164777","294268","459045","17.919","6.432","232199","368712","136513","14.393","5.329"
"Idaho","1994","2671267","122289","114332","4.28","27.654","20867","13.768","15756","10.396","154114","10752","10997","76374","185268","298415","483683","18.107","6.936","225409","369351","143942","13.827","5.389"
"Idaho","1995","2812751","126484","165663","5.89","26.591","21839","13.935","15663","9.994","159810","10763","11041","73008","210712","328921","539633","19.185","7.491","231234","373970","142736","13.296","5.075"
"Idaho","1996","2914101","129727","73739","2.53","30.446","22372","13.867","17070","10.58","163987","11584","11848","79076","198751","318603","517354","17.753","6.82","275708","443615","167907","15.223","5.762"
"Idaho","1997","2992180","131994","80986","2.707","33.035","22669","13.705","18705","11.308","167394","12387","12697","91968","215081","360131","575212","19.224","7.188","308717","494226","185509","16.517","6.2"
"Idaho","1998","3144000","135219","119932","3.815","30.868","23120","13.628","18515","10.914","171952","11737","12120","82124","236392","368790","605182","19.249","7.519","297423","485250","187827","15.434","5.974"
"Idaho","1999","3267430","137433","127378","3.898","29.553","22516","13.001","18712","10.804","175095","11923","12382","86940","225221","384966","610187","18.675","6.893","301450","482809","181359","14.776","5.551"
"Idaho","2000","3374202","138523","95117","2.819","30.684","22355","12.715","19599","11.148","177190","12229","12552","85642","222819","389973","612792","18.161","6.604","319833","517675","197842","15.342","5.863"
"Idaho","2001","3425194","139874","6075","0.177","32.785","22941","12.879","19636","11.023","179782","12030","12633","90124","221416","346137","567553","16.57","6.464","360628","561478","200850","16.393","5.864"
"Idaho","2002","3414415","141431","-98630","-2.889","33.051","24261","13.42","21605","11.951","182108","12691","13107","109268","236141","328101","564242","16.525","6.916","428847","662872","234025","19.414","6.854"
"Idaho","2003","3353141","144265","-11930","-0.356","31.455","23828","12.997","20195","11.015","185152","12239","12541","74448","193720","333637","527357","15.727","5.777","359454","539287","179833","16.083","5.363"
"Idaho","2004","3386545","148097","72786","2.149","28.842","23796","12.712","18901","10.097","189639","11956","12170","73114","192832","368324","561156","16.57","5.694","318757","488370","169613","14.421","5.008"
"Idaho","2005","3451424","152071","51556","1.494","28.907","25202","13.13","19791","10.311","194648","12620","12881","77666","206951","343459","550410","15.947","5.996","330291","498854","168563","14.454","4.884"
"Idaho","2006","3544183","157066","125416","3.539","27.208","28545","14.431","21074","10.654","201542","14276","14532","91243","240611","366961","607572","17.143","6.789","305897","482156","176259","13.604","4.973"
"Idaho","2007","3618788","160401","18794","0.519","30.889","27427","13.46","21502","10.552","206733","13735","14112","86524","225977","351716","577693","15.964","6.245","369215","558899","189684","15.444","5.242"
"Idaho","2008","3620118","158343","-12549","-0.347","30.341","23806","11.571","24628","11.971","205325","16287","16542","92894","199801","349387","549188","15.17","5.519","366827","561737","194910","15.517","5.384"
"Idaho","2009","3513020","151897","-232097","-6.607","24.573","20511","10.148","27232","13.474","198754","17646","18068","108328","182289","249342","431631","12.287","5.189","461441","663728","202287","18.893","5.758"
"Idaho","2010","3350961","148654","-80724","-2.409","23.92","19718","10.032","22892","11.646","194971","14251","14570","74771","142866","257903","400769","11.96","4.263","329068","481493","152425","14.369","4.549"
"Idaho","2011","3314811","147483","14041","0.424","26.084","20554","10.58","20847","10.731","194123","13189","13591","72163","149282","297075","446357","13.466","4.503","281552","432316","150764","13.042","4.548"
"Idaho","2012","3340475","148026","46080","1.379","25.532","20966","10.803","19835","10.221","194635","11746","11981","65852","160529","311991","472520","14.145","4.806","268096","426440","158344","12.766","4.74"
"Idaho","2013","3397299","149082","75519","2.223","22.973","20409","10.472","18518","9.501","195842","11280","11462","65642","139826","325922","465748","13.709","4.116","249444","390229","140785","11.486","4.144"
"Idaho","2014","3472604","150383","81495","2.347","22.684","21036","10.68","17761","9.017","198608","11456","11664","83490","147919","327437","475356","13.689","4.26","248727","393861","145134","11.342","4.179"
"Idaho","2015","3595298","152506","143287","3.985","21.839","21511","10.759","17777","8.891","201811","11238","11534","71407","177793","358082","535875","14.905","4.945","260132","392588","132456","10.919","3.684"
"Idaho","2016","3734862","155474","110639","2.962","20.935","22059","10.82","17106","8.39","206357","11450","11721","70804","169311","332282","501593","13.43","4.533","259597","390954","131357","10.468","3.517"
"Idaho","2017","3824966","157738","91702","2.397","24.001","21639","10.427","18392","8.862","209150","12083","12351","72525","180117","370595","550712","14.398","4.709","306353","459010","152657","12.0","3.991"
"Idaho","2018","3925914","159708","92845","2.365","22.73","20684","9.861","18515","8.827","210847","13282","13686","76048","164385","374640","539025","13.73","4.187","301395","446180","144785","11.365","3.688"
"Indiana","1978","271853","15715","21099","7.761","30.572","3091","16.805","2101","11.423","18888","1325","1345","7113","26540","36115","62655","23.047","9.763","23699","41556","17857","15.286","6.569"
"Indiana","1979","293801","16600","20063","6.829","25.965","3138","16.189","1837","9.477","20034","1170","1190","7444","21407","36799","58206","19.811","7.286","24401","38143","13742","12.983","4.677"
"Indiana","1980","308246","17341","10334","3.353","28.554","3132","15.359","1978","9.7","20969","1390","1422","7811","22312","32031","54343","17.63","7.238","30545","44009","13464","14.277","4.368"
"Indiana","1981","316878","17919","8621","2.721","30.043","3017","14.245","2094","9.887","21641","1360","1409","7277","22949","33272","56221","17.742","7.242","33788","47600","13812","15.022","4.359"
"Indiana","1982","316708","17839","-5704","-1.801","33.297","2822","13.107","2499","11.607","21692","1737","1757","10584","23844","28883","52727","16.648","7.529","42178","58431","16253","18.45","5.132"
"Indiana","1983","310008","18623","636","0.205","33.182","3167","14.444","1980","9.03","22520","1329","1368","10174","22304","29765","52069","16.796","7.195","33548","51433","17885","16.591","5.769"
"Indiana","1984","314115","18970","12142","3.865","28.002","2950","13.086","2204","9.776","22917","1493","1565","9164","21911","34210","56121","17.866","6.975","29403","43979","14576","14.001","4.64"
"Indiana","1985","334821","19031","32596","9.735","28.781","2813","12.353","2397","10.526","22980","1643","1694","10510","46724","34054","80778","24.126","13.955","28902","48182","19280","14.39","5.758"
"Indiana","1986","358575","19211","20338","5.672","25.155","2979","12.974","2149","9.359","23376","1429","1450","7627","25304","40133","65437","18.249","7.057","31183","45099","13916","12.577","3.881"
"Indiana","1987","367850","19639","-6233","-1.694","43.294","3365","14.329","2376","10.118","23978","1533","1582","10598","32176","47452","79628","21.647","8.747","67346","85861","18515","23.341","5.033"
"Indiana","1988","374734","20478","18269","4.875","28.532","3523","14.378","2318","9.46","25105","1585","1636","9246","29646","42083","71729","19.141","7.911","34465","53460","18995","14.266","5.069"
"Indiana","1989","395968","20950","28773","7.267","23.996","3335","13.168","2307","9.109","25841","1669","1698","11156","29868","46413","76281","19.264","7.543","30619","47508","16889","11.998","4.265"
"Indiana","1990","419204","21609","26532","6.329","24.14","3459","13.243","2316","8.867","26690","1598","1646","10047","30525","46605","77130","18.399","7.282","32604","50598","17994","12.07","4.292"
"Indiana","1991","434444","21934","4283","0.986","32.674","3620","13.421","2530","9.38","27518","1758","1807","13596","31689","43570","75259","17.323","7.294","49599","70976","21377","16.337","4.921"
"Indiana","1992","438516","21884","10255","2.339","28.216","3024","11.049","2545","9.299","27608","1681","1706","9980","24269","47851","72120","16.446","5.534","44517","61865","17348","14.108","3.956"
"Indiana","1993","438600","21859","-7561","-1.724","29.535","2926","10.641","2968","10.794","27477","1927","1970","10902","25457","39313","64770","14.767","5.804","50449","72331","21882","16.491","4.989"
"Indiana","1994","431732","21819","-8039","-1.862","27.96","2837","10.337","2862","10.428","27432","1973","2055","17084","25477","34880","60357","13.98","5.901","44733","68396","23663","15.842","5.481"
"Indiana","1995","424037","21913","-2127","-0.502","26.284","2909","10.582","2638","9.596","27626","1813","1857","10027","22625","33102","55727","13.142","5.336","39943","57854","17911","13.644","4.224"
"Indiana","1996","417201","21734","-2948","-0.707","29.093","2802","10.232","2868","10.473","27351","1847","1953","10222","27650","33039","60689","14.547","6.628","42332","63637","21305","15.253","5.107"
"Indiana","1997","418281","21668","912","0.218","28.749","2844","10.434","2916","10.698","27222","1866","1922","10789","21370","39667","61037","14.592","5.109","39584","60125","20541","14.374","4.911"
"Indiana","1998","414040","21679","-6504","-1.571","27.518","2647","9.735","2768","10.18","27131","1705","1743","9692","21999","34968","56967","13.759","5.313","40647","63471","22824","15.33","5.513"
"Indiana","1999","413637","21567","3604","0.871","26.812","2573","9.526","2662","9.855","26966","1651","1722","10720","24099","34958","59057","14.277","5.826","35019","55453","20434","13.406","4.94"
"Indiana","2000","423304","21770","14988","3.541","22.622","2615","9.681","2368","8.766","27136","1452","1502","8412","21953","40914","62867","14.852","5.186","27718","47879","20161","11.311","4.763"
"Indiana","2001","434776","22076","8882","2.043","24.157","2794","10.225","2351","8.604","27546","1403","1453","7972","23367","38029","61396","14.121","5.374","33621","52514","18893","12.078","4.345"
"Indiana","2002","442079","22234","-4198","-0.95","30.158","3066","11.064","2803","10.115","27844","1653","1695","12434","27917","38743","66660","15.079","6.315","47180","70858","23678","16.028","5.356"
"Indiana","2003","448623","22644","19047","4.246","22.932","2892","10.328","2440","8.714","28228","1460","1509","10032","21173","49312","70485","15.711","4.72","31538","51438","19900","11.466","4.436"
"Indiana","2004","464552","23072","13244","2.851","21.532","2842","9.978","2265","7.952","28772","1459","1496","8177","19558","43700","63258","13.617","4.21","35133","50014","14881","10.766","3.203"
"Indiana","2005","479518","23550","17052","3.556","22.746","3058","10.508","2321","7.976","29469","1490","1550","8054","26955","44632","71587","14.929","5.621","38046","54535","16489","11.373","3.439"
"Indiana","2006","498610","24163","22118","4.436","22.028","3554","11.858","2470","8.241","30513","1709","1738","9890","29491","47545","77036","15.45","5.915","37447","54918","17471","11.014","3.504"
"Indiana","2007","512956","24312","6773","1.32","27.093","3056","9.997","2785","9.11","30705","1669","1730","12008","24917","51344","76261","14.867","4.858","44478","69488","25010","13.547","4.876"
"Indiana","2008","516167","23983","-893","-0.173","25.836","2624","8.597","2841","9.308","30414","1829","1882","10762","21117","45562","66679","12.918","4.091","47024","67572","20548","13.091","3.981"
"Indiana","2009","500911","23553","-31943","-6.377","19.616","2533","8.385","3008","9.957","29973","1900","1958","12734","19134","29996","49130","9.808","3.82","59716","81073","21357","16.185","4.264"
"Indiana","2010","481131","23110","-7629","-1.586","23.398","2383","8.008","2704","9.087","29597","1693","1740","8922","20855","35432","56287","11.699","4.335","46462","63916","17454","13.285","3.628"
"Indiana","2011","479334","22794","5477","1.143","21.247","2385","8.102","2561","8.7","29348","1597","1641","8713","19379","37021","56400","11.766","4.043","34134","50923","16789","10.624","3.503"
"Indiana","2012","485461","22674","7686","1.583","20.887","2281","7.813","2435","8.34","29119","1370","1400","7475","16870","41514","58384","12.027","3.475","34786","50698","15912","10.443","3.278"
"Indiana","2013","495212","22727","12451","2.514","19.461","2477","8.505","2327","7.99","29198","1360","1407","10055","19159","41478","60637","12.245","3.869","28998","48186","19188","9.73","3.875"
"Indiana","2014","509726","22715","16730","3.282","18.148","2456","8.389","2192","7.487","29409","1449","1466","7925","23116","39867","62983","12.356","4.535","31799","46253","14454","9.074","2.836"
"Indiana","2015","521103","22745","5716","1.097","19.367","2462","8.36","2277","7.732","29541","1481","1500","9276","17195","38981","56176","10.78","3.3","34551","50460","15909","9.683","3.053"
"Indiana","2016","526985","22994","6065","1.151","19.966","2627","8.831","2156","7.247","29984","1420","1483","8110","18648","40026","58674","11.134","3.539","39484","52609","13125","9.983","2.491"
"Indiana","2017","535846","23005","12691","2.368","22.085","2490","8.3","2346","7.82","30073","1547","1571","8164","27804","44059","71863","13.411","5.189","43517","59172","15655","11.043","2.922"
"Indiana","2018","546854","23119","7960","1.456","19.422","2428","8.061","2252","7.477","30208","1644","1692","11040","18384","42681","61065","11.167","3.362","37274","53105","15831","9.711","2.895"
"Iowa","1978","228038","17181","20302","8.903","35.143","3625","18.755","2550","13.193","19866","1738","1756","8171","24696","35676","60372","26.475","10.83","23683","40070","16387","17.572","7.186"
"Iowa","1979","242239","17711","6714","2.772","35.065","3251","16.164","2434","12.102","20521","1763","1775","8787","19617","29568","49185","20.304","8.098","26763","42471","15708","17.533","6.485"
"Iowa","1980","244730","17651","191","0.078","36.273","2968","14.543","2836","13.897","20474","1994","2020","9669","18244","26332","44576","18.214","7.455","28127","44385","16258","18.136","6.643"
"Iowa","1981","242981","17452","-2067","-0.851","32.805","2672","13.16","2547","12.545","20366","1753","1787","8370","15989","23866","39855","16.403","6.58","27477","41922","14445","17.253","5.945"
"Iowa","1982","236058","17097","-6571","-2.784","33.839","2857","14.175","2820","13.991","20174","1954","1966","8440","18455","21485","39940","16.92","7.818","31979","46511","14532","19.703","6.156"
"Iowa","1983","233094","17552","3979","1.707","33.992","2885","14.256","2114","10.446","20622","1451","1480","7486","19589","24006","43595","18.703","8.404","25776","39616","13840","16.996","5.938"
"Iowa","1984","241241","18407","14539","6.027","27.135","3234","15.444","2019","9.642","21548","1491","1503","7360","16640","30629","47269","19.594","6.898","20896","32730","11834","13.567","4.905"
"Iowa","1985","248590","18550","6559","2.638","31.346","3105","14.458","2599","12.102","21729","1880","1913","10237","16743","28777","45520","18.311","6.735","24003","38961","14958","15.673","6.017"
"Iowa","1986","252781","18541","4642","1.836","32.536","2984","13.842","2572","11.931","21764","1814","1835","9297","17420","28344","45764","18.104","6.891","27313","41122","13809","16.268","5.463"
"Iowa","1987","258497","18567","-7896","-3.055","37.255","2991","13.87","2583","11.978","21768","1729","1761","10668","20313","27838","48151","18.627","7.858","39577","56047","16470","21.682","6.371"
"Iowa","1988","261345","18966","15003","5.741","31.266","3045","13.821","2344","10.639","22382","1645","1666","10890","23765","32094","55859","21.374","9.093","24872","40856","15984","15.633","6.116"
"Iowa","1989","279859","19369","23827","8.514","27.015","2989","13.278","2266","10.066","22872","1575","1617","9154","23945","37684","61629","22.021","8.556","23967","37802","13835","13.508","4.944"
"Iowa","1990","299491","20429","17022","5.684","27.939","3411","14.607","2013","8.62","24051","1468","1493","8855","20505","38354","58859","19.653","6.847","28255","41837","13582","13.969","4.535"
"Iowa","1991","308905","20770","5266","1.705","32.958","3150","13.006","2304","9.513","24642","1608","1631","9535","20817","35353","56170","18.184","6.739","31388","50904","19516","16.479","6.318"
"Iowa","1992","317349","21457","15971","5.033","28.03","3297","13.264","2201","8.855","25404","1470","1506","7818","21496","38951","60447","19.047","6.774","30890","44476","13586","14.015","4.281"
"Iowa","1993","331634","22314","14792","4.46","26.623","3366","13.069","2350","9.124","26264","1513","1545","8919","20786","38152","58938","17.772","6.268","29226","44146","14920","13.312","4.499"
"Iowa","1994","351601","23621","23215","6.603","25.684","3932","14.564","2428","8.993","27750","1651","1687","9669","23507","44861","68368","19.445","6.686","30040","45153","15113","12.842","4.298"
"Iowa","1995","368667","24630","12116","3.286","28.2","3854","13.645","2673","9.463","28836","1856","1884","8860","22117","41981","64098","17.386","5.999","31811","51982","20171","14.1","5.471"
"Iowa","1996","377854","25311","13827","3.659","30.529","4016","13.795","2966","10.188","29637","2033","2058","11111","26179","45325","71504","18.924","6.928","37143","57677","20534","15.264","5.434"
"Iowa","1997","390402","26065","10064","2.578","32.584","4361","14.516","3393","11.294","30527","2241","2287","13467","27255","46413","73668","18.87","6.981","39038","63604","24566","16.292","6.292"
"Iowa","1998","413141","26653","20698","5.01","29.026","4069","13.163","3279","10.608","31307","2237","2257","11142","32537","48120","80657","19.523","7.876","40500","59959","19459","14.513","4.71"
"Iowa","1999","430293","27208","13774","3.201","27.145","4190","13.207","3125","9.85","32257","2142","2176","14468","29187","42988","72175","16.773","6.783","35301","58401","23100","13.572","5.368"
"Iowa","2000","447423","27519","11436","2.556","31.844","3964","12.243","3419","10.56","32649","2195","2270","12880","34411","48263","82674","18.478","7.691","47657","71238","23581","15.922","5.27"
"Iowa","2001","458359","27805","9931","2.167","30.804","4207","12.84","3755","11.46","32992","2236","2308","13697","30269","50258","80527","17.569","6.604","45564","70596","25032","15.402","5.461"
"Iowa","2002","458032","28109","-11423","-2.494","35.732","4447","13.389","3746","11.278","33565","2238","2289","17821","34139","47693","81832","17.866","7.453","62717","93255","30538","20.36","6.667"
"Iowa","2003","457860","29028","12016","2.624","28.545","4594","13.508","3427","10.076","34594","2162","2203","9994","26813","50550","77363","16.897","5.856","44144","65347","21203","14.272","4.631"
"Iowa","2004","473711","30078","20042","4.231","27.093","4620","13.161","3382","9.635","35722","2100","2127","11371","38780","45433","84213","17.777","8.186","41445","64171","22726","13.546","4.797"
"Iowa","2005","499205","31716","29536","5.917","25.04","5364","14.644","3479","9.498","37573","2284","2318","13087","36526","55510","92036","18.437","7.317","42673","62500","19827","12.52","3.972"
"Iowa","2006","527467","33810","27810","5.272","26.161","6655","17.186","4048","10.454","40026","2953","2980","18994","37386","59418","96804","18.353","7.088","42875","68994","26119","13.08","4.952"
"Iowa","2007","543293","35076","4428","0.815","32.757","5827","14.303","4077","10.007","41615","2788","2813","15989","35008","58404","93412","17.194","6.444","63587","88984","25397","16.379","4.675"
"Iowa","2008","539497","34419","-10173","-1.886","27.271","4718","11.423","5025","12.166","41150","3501","3548","15613","26980","46582","73562","13.635","5.001","59000","83735","24735","15.521","4.585"
"Iowa","2009","516808","32523","-36275","-7.019","22.117","3703","9.209","5546","13.792","39289","3644","3688","16953","23206","33944","57150","11.058","4.49","66316","93425","27109","18.077","5.245"
"Iowa","2010","493524","31807","-9208","-1.866","25.129","3960","10.186","4571","11.757","38573","2943","3008","12101","20959","41050","62009","12.565","4.247","51833","71217","19384","14.43","3.928"
"Iowa","2011","484743","30990","-6204","-1.28","24.693","3797","9.965","4422","11.605","37791","2757","2847","13112","19332","40516","59848","12.346","3.988","45261","66052","20791","13.626","4.289"
"Iowa","2012","487375","31077","12907","2.648","23.593","3929","10.409","3761","9.964","37829","2287","2325","10130","22930","47469","70399","14.445","4.705","35965","57492","21527","11.796","4.417"
"Iowa","2013","499267","31305","10812","2.166","23.502","3943","10.409","3540","9.345","38083","2292","2309","11072","18857","50625","69482","13.917","3.777","34382","58670","24288","11.751","4.865"
"Iowa","2014","516055","31995","25907","5.02","19.753","4195","10.903","3147","8.179","39000","2093","2134","8844","22493","54381","76874","14.896","4.359","35922","50967","15045","9.876","2.915"
"Iowa","2015","538507","32541","17460","3.242","20.108","4179","10.618","3317","8.428","39788","2211","2243","10011","21535","50066","71601","13.296","3.999","35127","54141","19014","10.054","3.531"
"Iowa","2016","555274","33242","17450","3.143","21.223","4401","10.944","3353","8.338","40737","2290","2346","10076","24851","51522","76373","13.754","4.475","40940","58923","17983","10.612","3.239"
"Iowa","2017","569731","33776","14715","2.583","22.456","4331","10.57","3587","8.754","41346","2384","2427","10917","24060","54624","78684","13.811","4.223","43769","63969","20200","11.228","3.546"
"Iowa","2018","586371","34946","19872","3.389","22.114","4727","11.266","3348","7.98","42647","2520","2593","11972","28678","56030","84708","14.446","4.891","44150","64836","20686","11.057","3.528"
"Kansas","1978","3927526","179042","211359","5.381","26.617","27588","13.35","22328","10.805","209276","14977","15230","85843","246275","487770","734045","18.69","6.27","315744","522686","206942","13.308","5.269"
"Kansas","1979","4112692","181321","158254","3.848","26.861","25574","12.197","20245","9.656","212336","13112","13366","76844","230323","480282","710605","17.278","5.6","359903","552351","192448","13.43","4.679"
"Kansas","1980","4137299","179543","-86604","-2.093","27.405","24107","11.438","22492","10.672","211566","15091","15302","86200","217121","349802","566923","13.703","5.248","456532","653527","196995","15.796","4.761"
"Kansas","1981","4052849","180626","-67750","-1.672","26.882","23828","11.273","19660","9.301","213450","12632","12890","73451","217143","327593","544736","13.441","5.358","453672","612486","158814","15.112","3.919"
"Kansas","1982","3974538","179539","-73672","-1.854","28.81","24402","11.502","22607","10.656","213055","15406","15796","80629","254060","318478","572538","14.405","6.392","463437","646210","182773","16.259","4.599"
"Kansas","1983","3864138","183001","-7930","-0.205","31.494","25528","11.978","18226","8.552","216781","12244","12533","71661","238142","370349","608491","15.747","6.163","461957","616421","154464","15.952","3.997"
"Kansas","1984","3921040","186403","188654","4.811","25.005","27276","12.546","20446","9.404","220828","14683","14910","88998","228747","450127","678874","17.314","5.834","316038","490220","174182","12.502","4.442"
"Kansas","1985","4022056","187444","121663","3.025","28.917","26837","12.221","21656","9.861","222195","15404","15771","103044","267022","436167","703189","17.483","6.639","366767","581526","214759","14.458","5.34"
"Kansas","1986","4109298","189198","122334","2.977","27.092","26898","12.138","20270","9.147","224907","14320","14538","92304","238220","440753","678973","16.523","5.797","376042","556639","180597","13.546","4.395"
"Kansas","1987","4167914","190444","8628","0.207","32.85","28730","12.814","22325","9.957","227416","15046","15319","94180","264882","428323","693205","16.632","6.355","452387","684577","232190","16.425","5.571"
"Kansas","1988","4277582","195784","176322","4.122","26.948","29000","12.554","20729","8.973","235138","14341","14612","93917","271113","481570","752683","17.596","6.338","380749","576361","195612","13.474","4.573"
"Kansas","1989","4426133","199084","169787","3.836","26.095","29170","12.348","21147","8.952","240239","14629","15070","95411","281199","466092","747291","16.884","6.353","390996","577504","186508","13.048","4.214"
"Kansas","1990","4567598","203005","140920","3.085","24.505","28131","11.646","20660","8.553","245283","14871","15189","97129","238613","461951","700564","15.338","5.224","394280","559644","165364","12.252","3.62"
"Kansas","1991","4602271","202886","-34537","-0.75","28.399","28039","11.442","22817","9.311","247662","16132","16534","129693","255582","397927","653509","14.2","5.553","475583","688046","212463","14.95","4.616"
"Kansas","1992","4565238","203687","22330","0.489","29.601","26967","10.921","22404","9.073","249205","14615","14988","109193","234115","463890","698005","15.29","5.128","467967","675675","207708","14.8","4.55"
"Kansas","1993","4620287","207298","40200","0.87","28.41","26801","10.695","22854","9.12","252562","15031","15458","92678","231815","464704","696519","15.075","5.017","459927","656319","196392","14.205","4.251"
"Kansas","1994","4705231","210808","106354","2.26","25.909","27719","10.879","23169","9.093","257065","15829","16185","118224","239868","476035","715903","15.215","5.098","386168","609549","223381","12.955","4.748"
"Kansas","1995","4833491","214931","152689","3.159","25.122","29012","11.181","22899","8.825","262536","15456","15841","101844","272465","487358","759823","15.72","5.637","410690","607134","196444","12.561","4.064"
"Kansas","1996","4876468","216243","31819","0.653","27.731","28479","10.832","24486","9.313","264914","16714","17165","101916","246769","461203","707972","14.518","5.06","469854","676153","206299","13.866","4.231"
"Kansas","1997","4955378","217455","88091","1.778","28.806","29071","10.954","27029","10.185","266403","17422","17951","121226","276060","525765","801825","16.181","5.571","460519","713734","253215","14.403","5.11"
"Kansas","1998","5120108","220301","129981","2.539","26.048","27994","10.42","23921","8.904","270681","15567","15952","98347","258855","537962","796817","15.563","5.056","451320","666836","215516","13.024","4.209"
"Kansas","1999","5251330","220816","100810","1.92","25.821","26953","9.941","24698","9.109","272261","15831","16311","104671","254287","524494","778781","14.83","4.842","445776","677971","232195","12.91","4.422"
"Kansas","2000","5356443","221153","118094","2.205","27.347","27295","10.011","25388","9.311","273617","15938","16416","112624","265856","584649","850505","15.878","4.963","457742","732411","274669","13.673","5.128"
"Kansas","2001","5396118","220331","-52337","-0.97","28.036","26621","9.741","25913","9.481","273655","16310","16894","110936","268909","487515","756424","14.018","4.983","547192","808761","261569","14.988","4.847"
"Kansas","2002","5281633","218828","-231602","-4.385","29.649","29589","10.822","29550","10.808","273438","17337","18074","173582","311133","471843","782976","14.825","5.891","668649","1014578","345929","19.21","6.55"
"Kansas","2003","5170112","220133","18074","0.35","28.542","28399","10.364","26114","9.53","275164","15738","16091","109979","241245","514653","755898","14.621","4.666","492730","737824","245094","14.271","4.741"
"Kansas","2004","5191886","222957","26955","0.519","26.946","28774","10.407","25303","9.152","278213","15559","16278","103895","224426","502024","726450","13.992","4.323","475889","699495","223606","13.473","4.307"
"Kansas","2005","5209387","225325","18590","0.357","26.604","30301","10.837","26402","9.443","281546","16492","16904","104003","258700","452847","711547","13.659","4.966","478168","692957","214789","13.302","4.123"
"Kansas","2006","5284307","228423","123230","2.332","25.111","32797","11.558","26775","9.435","286781","17569","17915","116978","280240","506469","786709","14.888","5.303","438080","663479","225399","12.556","4.265"
"Kansas","2007","5348336","229071","2070","0.039","28.875","30847","10.736","28073","9.771","288703","17398","17684","111802","264688","509556","774244","14.476","4.949","527159","772174","245015","14.438","4.581"
"Kansas","2008","5367626","226810","43294","0.807","26.084","28381","9.862","29124","10.12","287403","18697","18988","105381","221494","521856","743350","13.849","4.126","478703","700056","221353","13.042","4.124"
"Kansas","2009","5233128","221525","-336403","-6.428","20.255","24827","8.724","31309","11.001","281353","19402","19772","120954","189556","340439","529995","10.128","3.622","629281","866398","237117","16.556","4.531"
"Kansas","2010","5010856","218646","-140928","-2.812","21.551","25455","9.101","27813","9.944","278521","16727","17046","97526","190791","349147","539938","10.775","3.808","489599","680866","191267","13.588","3.817"
"Kansas","2011","4982440","218236","82152","1.649","21.576","26914","9.67","26323","9.458","278609","16301","16802","84472","186320","433341","619661","12.437","3.74","368065","537509","169444","10.788","3.401"
"Kansas","2012","5056047","219268","74125","1.466","23.26","26542","9.531","25475","9.148","279012","14877","15414","82663","194023","468131","662154","13.096","3.837","387629","588029","200400","11.63","3.964"
"Kansas","2013","5123167","219113","67305","1.314","22.212","26210","9.404","25428","9.124","279097","15451","15741","95903","195520","440760","636280","12.42","3.816","380522","568975","188453","11.106","3.678"
"Kansas","2014","5204699","219172","97316","1.87","20.602","25914","9.274","24356","8.716","280205","15356","15619","82528","189137","444316","633453","12.171","3.634","356733","536137","179404","10.301","3.447"
"Kansas","2015","5293331","220614","148273","2.801","21.263","26527","9.438","23891","8.5","282390","14941","15345","83463","203508","507532","711040","13.433","3.845","383318","562767","179449","10.632","3.39"
"Kansas","2016","5394021","222317","44660","0.828","22.57","26757","9.431","23256","8.197","285459","15641","15997","85144","208941","444435","653376","12.113","3.874","438634","608716","170082","11.285","3.153"
"Kansas","2017","5403446","222121","-1496","-0.028","24.369","25463","8.93","25095","8.801","285334","16196","16691","112317","194343","464032","658375","12.184","3.597","429212","659871","230659","12.212","4.269"
"Kansas","2018","5436957","221826","56998","1.048","21.838","23575","8.279","23839","8.371","284633","17255","17736","92378","195450","455209","650659","11.967","3.595","423797","593661","169864","10.919","3.124"
"Kentucky","1978","1714132","81323","99981","5.833","24.603","13038","13.565","10211","10.624","97526","6669","6757","33821","101522","209324","310846","18.134","5.923","127216","210865","83649","12.302","4.88"
"Kentucky","1979","1817586","83135","92176","5.071","22.523","12182","12.374","9040","9.183","100018","6236","6324","32635","97117","199742","296859","16.333","5.343","129224","204683","75459","11.261","4.152"
"Kentucky","1980","1829431","82272","-72119","-3.942","25.415","10971","11.02","10538","10.585","99775","7296","7417","36810","98856","133619","232475","12.708","5.404","229281","304594","75313","16.65","4.117"
"Kentucky","1981","1769062","81920","-41600","-2.352","24.115","10249","10.31","9392","9.448","99841","6188","6324","30701","85457","127844","213301","12.057","4.831","184951","254901","69950","14.409","3.954"
"Kentucky","1982","1717804","81514","-49945","-2.907","25.936","11140","11.213","10329","10.396","99757","7043","7225","34893","88559","134210","222769","12.968","5.155","198791","272714","73923","15.876","4.303"
"Kentucky","1983","1671582","82508","-28068","-1.679","28.326","12094","12.173","9420","9.481","100689","6579","6704","32970","94321","142425","236746","14.163","5.643","198156","264814","66658","15.842","3.988"
"Kentucky","1984","1709011","85697","117412","6.87","24.403","14392","14.073","10614","10.379","104156","8002","8135","46135","118304","207629","325933","19.071","6.922","117909","208521","90612","12.201","5.302"
"Kentucky","1985","1796006","86467","96350","5.365","26.491","13106","12.632","10022","9.659","105295","7136","7311","45847","147180","187056","334236","18.61","8.195","152355","237886","85531","13.245","4.762"
"Kentucky","1986","1855692","87469","50502","2.721","27.165","12997","12.372","9930","9.453","106581","6786","6929","43531","121231","181323","302554","16.304","6.533","162708","252052","89344","13.583","4.815"
"Kentucky","1987","1905914","88952","45522","2.388","30.712","13835","12.936","10110","9.453","108812","6963","7062","46228","130364","207834","338198","17.745","6.84","197024","292676","95652","15.356","5.019"
"Kentucky","1988","1969975","91525","82228","4.174","26.166","13884","12.557","9847","8.906","112585","6867","7007","49799","127374","212589","339963","17.257","6.466","170421","257735","87314","13.083","4.432"
"Kentucky","1989","2058929","93417","104494","5.075","23.807","13778","12.145","9766","8.608","115454","6968","7157","47090","127253","222325","349578","16.979","6.181","156618","245084","88466","11.903","4.297"
"Kentucky","1990","2129449","95173","50742","2.383","24.613","13446","11.57","9833","8.461","118018","7226","7422","45738","109502","203297","312799","14.689","5.142","184374","262057","77683","12.306","3.648"
"Kentucky","1991","2125233","95187","-28691","-1.35","27.547","13373","11.316","10694","9.049","119518","7662","7860","60586","118075","174646","292721","13.774","5.556","224201","321412","97211","15.124","4.574"
"Kentucky","1992","2148232","95872","45890","2.136","29.008","12836","10.74","10268","8.591","120798","6916","7080","46401","132388","225084","357472","16.64","6.163","217766","311582","93816","14.504","4.367"
"Kentucky","1993","2196551","98020","52838","2.405","25.105","12809","10.532","10323","8.488","122864","6909","7101","43903","101006","227555","328561","14.958","4.598","184614","275723","91109","12.553","4.148"
"Kentucky","1994","2256926","100203","50117","2.221","25.154","13404","10.79","10435","8.4","125711","7192","7482","51193","109823","224148","333971","14.798","4.866","183398","283854","100456","12.577","4.451"
"Kentucky","1995","2331547","102412","101080","4.335","22.747","14355","11.29","10695","8.412","128977","7485","7738","45666","130738","235521","366259","15.709","5.607","178156","265179","87023","11.374","3.732"
"Kentucky","1996","2368986","103135","16782","0.708","27.546","13682","10.587","11486","8.887","130336","7914","8156","50824","130202","212866","343068","14.482","5.496","222367","326286","103919","13.773","4.387"
"Kentucky","1997","2412908","103568","47256","1.958","27.951","14233","10.893","12769","9.772","131397","8442","8730","59791","125049","259427","384476","15.934","5.183","220766","337220","116454","13.976","4.826"
"Kentucky","1998","2503550","104561","62174","2.483","25.535","13492","10.205","11800","8.925","133053","7694","7898","49548","135056","246756","381812","15.251","5.395","213288","319638","106350","12.767","4.248"
"Kentucky","1999","2561344","104326","47369","1.849","25.386","12644","9.501","11839","8.896","133482","7965","8211","56035","125030","247454","372484","14.543","4.881","217076","325115","108039","12.693","4.218"
"Kentucky","2000","2634471","103889","96364","3.658","23.956","12686","9.522","12441","9.338","133352","7873","8146","48626","134792","277125","411917","15.636","5.116","202251","315553","113302","11.978","4.301"
"Kentucky","2001","2627327","103145","-60360","-2.297","25.864","12662","9.53","12661","9.529","132865","7697","7950","55310","120452","219314","339766","12.932","4.585","266571","400126","133555","15.229","5.083"
"Kentucky","2002","2572365","103324","-82353","-3.201","29.341","14325","10.747","13269","9.954","133826","7809","8195","71359","153849","223527","377376","14.67","5.981","316295","459729","143434","17.872","5.576"
"Kentucky","2003","2533950","103624","10263","0.405","28.156","12865","9.608","12003","8.964","134328","7387","7629","50013","114051","252940","366991","14.483","4.501","231430","356728","125298","14.078","4.945"
"Kentucky","2004","2559309","104681","44202","1.727","24.142","13245","9.808","11328","8.389","135995","7354","7612","49210","113081","240052","353133","13.798","4.418","211669","308931","97262","12.071","3.8"
"Kentucky","2005","2589405","104848","18494","0.714","24.634","13027","9.572","12142","8.921","136542","7820","8065","51496","115009","222425","337434","13.031","4.442","218385","318940","100555","12.317","3.883"
"Kentucky","2006","2626892","105878","52312","1.991","23.928","14925","10.85","12101","8.797","138964","7989","8162","48955","128635","237953","366588","13.955","4.897","218083","314276","96193","11.964","3.662"
"Kentucky","2007","2642990","105735","-23070","-0.873","27.583","14098","10.132","12790","9.192","139794","8151","8333","53997","122012","242500","364512","13.792","4.616","277503","387582","110079","14.665","4.165"
"Kentucky","2008","2614231","104234","-33418","-1.278","24.992","12195","8.784","13427","9.672","138211","8557","8783","57797","98653","228019","326672","12.496","3.774","244334","360090","115756","13.774","4.428"
"Kentucky","2009","2516459","101292","-166227","-6.606","20.432","10373","7.593","13673","10.008","134968","8671","8934","56180","82760","174316","257076","10.216","3.289","312553","423303","110750","16.821","4.401"
"Kentucky","2010","2413274","99563","-38725","-1.605","22.477","10204","7.618","11596","8.657","133254","7288","7478","43654","86176","185039","271215","11.238","3.571","225630","309940","84310","12.843","3.494"
"Kentucky","2011","2411933","98476","41691","1.729","20.61","10896","8.208","11204","8.44","132597","7055","7380","38043","78677","211565","290242","12.034","3.262","178141","248551","70410","10.305","2.919"
"Kentucky","2012","2468035","98557","74793","3.03","21.18","11171","8.434","10718","8.092","132678","6342","6567","38975","96619","239534","336153","13.62","3.915","181697","261360","79663","10.59","3.228"
"Kentucky","2013","2523264","97959","36528","1.448","20.906","10267","7.765","10456","7.908","132131","6492","6593","40037","80612","219668","300280","11.9","3.195","185806","263752","77946","10.453","3.089"
"Kentucky","2014","2569528","97382","58781","2.288","19.36","10527","7.977","10176","7.711","132145","6420","6540","39047","85728","221777","307505","11.967","3.336","172998","248724","75726","9.68","2.947"
"Kentucky","2015","2630450","97689","67816","2.578","19.572","11353","8.553","9599","7.231","133617","6006","6196","36197","95059","230173","325232","12.364","3.614","189032","257416","68384","9.786","2.6"
"Kentucky","2016","2694197","98257","61862","2.296","19.139","11395","8.466","8941","6.643","135824","6082","6266","36840","98648","221029","319677","11.865","3.661","195934","257815","61881","9.569","2.297"
"Kentucky","2017","2744185","98589","51578","1.88","21.537","10649","7.837","9848","7.247","136283","6093","6245","42555","89384","257697","347081","12.648","3.257","209425","295503","86078","10.768","3.137"
"Kentucky","2018","2790965","98936","36519","1.308","21.309","10343","7.595","9960","7.314","136371","6752","7141","53647","88024","245860","333884","11.963","3.154","200638","297365","96727","10.655","3.466"
"Louisiana","1978","835728","55817","58963","7.055","25.694","8705","13.555","6684","10.408","65232","4684","4734","22794","58698","107632","166330","19.902","7.024","64028","107367","43339","12.847","5.186"
"Louisiana","1979","883624","56358","37612","4.257","25.665","7790","11.911","6651","10.169","65971","4591","4643","22995","53862","97143","151005","17.089","6.096","69806","113393","43587","12.833","4.933"
"Louisiana","1980","899999","55978","-878","-0.098","29.3","7155","10.897","6885","10.486","65796","5023","5066","24020","54008","77844","131852","14.65","6.001","93033","132730","39697","14.748","4.411"
"Louisiana","1981","883488","56051","-25910","-2.933","27.858","6973","10.603","6023","9.159","66239","4299","4386","19381","63090","59969","123059","13.929","7.141","99563","148969","49406","16.861","5.592"
"Louisiana","1982","855054","54150","-29752","-3.48","26.585","6798","10.436","7480","11.483","64796","5333","5419","23912","48693","64966","113659","13.293","5.695","98944","143411","44467","16.772","5.2"
"Louisiana","1983","838936","54852","7884","0.94","34.3","6869","10.633","5335","8.258","65368","3729","3790","18806","78685","73078","151763","18.09","9.379","99982","143879","43897","17.15","5.232"
"Louisiana","1984","857060","55932","36177","4.221","23.408","7741","11.811","5579","8.512","66620","4120","4192","18756","47177","89311","136488","15.925","5.505","68568","100311","31743","11.704","3.704"
"Louisiana","1985","859299","54546","-17839","-2.076","29.13","6635","10.154","6988","10.694","65168","5140","5223","25620","45760","79395","125155","14.565","5.325","70854","142994","72140","16.641","8.395"
"Louisiana","1986","852438","53417","17284","2.028","29.024","6417","10.009","6409","9.996","64119","4554","4637","23252","60574","80417","140991","16.54","7.106","78178","123707","45529","14.512","5.341"
"Louisiana","1987","874888","52972","9765","1.116","31.651","7003","11.051","6173","9.741","63785","4137","4199","23633","59652","88570","148222","16.942","6.818","88847","138457","49610","15.826","5.67"
"Louisiana","1988","905439","53866","50794","5.61","23.446","6875","10.671","5347","8.3","65188","3770","3849","23309","52901","104037","156938","17.333","5.843","67388","106144","38756","11.723","4.28"
"Louisiana","1989","960100","54376","61294","6.384","21.789","6742","10.329","5251","8.045","66015","3781","3871","23648","64293","101599","165892","17.279","6.696","66926","104598","37672","10.894","3.924"
"Louisiana","1990","991772","55131","32862","3.313","22.46","6725","10.145","5007","7.553","67149","3689","3785","20910","47127","97112","144239","14.544","4.752","80249","111377","31128","11.23","3.139"
"Louisiana","1991","1009940","55208","11997","1.188","25.0","6769","10.067","5161","7.675","68045","3689","3768","22309","45978","92262","138240","13.688","4.553","88997","126243","37246","12.5","3.688"
"Louisiana","1992","1018636","55564","23728","2.329","25.74","6580","9.677","5318","7.821","68630","3579","3662","22918","52248","102580","154828","15.2","5.129","91677","131100","39423","12.87","3.87"
"Louisiana","1993","1039859","56242","21184","2.037","23.081","6284","9.134","5527","8.034","69174","3679","3754","18242","45015","96173","141188","13.578","4.329","85439","120004","34565","11.54","3.324"
"Louisiana","1994","1065150","57004","19910","1.869","23.672","6702","9.614","5599","8.032","70262","3947","4058","25368","47092","98890","145982","13.705","4.421","80033","126072","46039","11.836","4.322"
"Louisiana","1995","1096798","57759","39850","3.633","21.2","6924","9.791","5626","7.956","71367","3964","4075","23668","48571","107537","156108","14.233","4.428","76685","116258","39573","10.6","3.608"
"Louisiana","1996","1126155","57961","25750","2.287","22.728","6706","9.395","5763","8.074","71849","4065","4149","21786","52789","100939","153728","13.651","4.688","87892","127978","40086","11.364","3.56"
"Louisiana","1997","1149198","58030","14818","1.289","27.832","6931","9.646","6462","8.993","72087","4248","4361","27372","63854","110889","174743","15.206","5.556","101902","159925","58023","13.916","5.049"
"Louisiana","1998","1195545","58659","47308","3.957","21.36","6750","9.295","5834","8.034","73074","3870","3964","20833","55394","119596","174990","14.637","4.633","87447","127682","40235","10.68","3.365"
"Louisiana","1999","1231698","58501","24915","2.023","24.461","6464","8.837","5958","8.146","73397","4087","4203","23859","58041","117516","175557","14.253","4.712","99154","150642","51488","12.23","4.18"
"Louisiana","2000","1262240","58357","27804","2.203","22.531","6197","8.456","6079","8.295","73343","3947","4080","22789","58409","111594","170003","13.468","4.627","91974","142199","50225","11.266","3.979"
"Louisiana","2001","1259133","57583","-13788","-1.095","22.951","6039","8.269","6360","8.709","72867","4127","4268","24288","48645","95849","144494","11.476","3.863","111640","158282","46642","12.571","3.704"
"Louisiana","2002","1245377","57320","-33651","-2.702","25.749","6766","9.29","6813","9.355","72805","3998","4138","31167","60851","99484","160335","12.874","4.886","131913","193986","62073","15.576","4.984"
"Louisiana","2003","1226912","57601","-979","-0.08","25.094","6725","9.234","6278","8.62","73050","3647","3734","19685","52775","101165","153940","12.547","4.301","108573","154919","46346","12.627","3.777"
"Louisiana","2004","1232673","57890","16385","1.329","22.995","6390","8.738","5909","8.08","73373","3751","3833","20961","45841","112273","158114","12.827","3.719","95028","141729","46701","11.498","3.789"
"Louisiana","2005","1252551","58391","24122","1.926","21.146","6676","9.06","5882","7.982","74087","3924","4009","20357","50902","105653","156555","12.499","4.064","93527","132433","38906","10.573","3.106"
"Louisiana","2006","1279730","58281","31242","2.441","21.862","8136","10.936","6849","9.206","75039","4891","4988","23918","62013","109118","171131","13.372","4.846","96073","139889","43816","10.931","3.424"
"Louisiana","2007","1294555","58280","257","0.02","24.662","6691","8.915","6196","8.255","75301","3893","3957","21830","47393","112494","159887","12.351","3.661","114466","159630","45164","12.331","3.489"
"Louisiana","2008","1299626","57613","13429","1.033","22.629","5989","7.995","6443","8.601","74686","4117","4202","21932","43544","116934","160478","12.348","3.351","103209","147049","43840","11.315","3.373"
"Louisiana","2009","1290660","56816","-30197","-2.34","21.49","5341","7.182","6137","8.252","73970","4058","4119","23547","43309","95374","138683","10.745","3.356","129567","168880","39313","13.085","3.046"
"Louisiana","2010","1260907","56389","-27027","-2.143","19.247","5373","7.284","5465","7.409","73718","3383","3458","23400","36127","85215","121342","9.623","2.865","109262","148369","39107","11.767","3.101"
"Louisiana","2011","1250645","55947","10735","0.858","19.654","5505","7.487","5538","7.532","73512","3499","3572","18145","37840","95793","133633","10.685","3.026","87781","122898","35117","9.827","2.808"
"Louisiana","2012","1269061","56156","23576","1.858","19.473","5666","7.705","5258","7.15","73739","3192","3265","18406","35707","111430","147137","11.594","2.814","85272","123561","38289","9.736","3.017"
"Louisiana","2013","1288162","55621","16026","1.244","18.524","5322","7.238","5419","7.37","73476","3311","3357","16208","38425","96911","135336","10.506","2.983","88662","119310","30648","9.262","2.379"
"Louisiana","2014","1300192","55539","9228","0.71","17.677","5234","7.128","4986","6.79","73556","3208","3304","16868","36631","87517","124148","9.548","2.817","81073","114920","33847","8.839","2.603"
"Louisiana","2015","1319672","55778","31430","2.382","16.901","5652","7.661","4968","6.734","74118","3156","3230","15971","41950","100996","142946","10.832","3.179","79947","111516","31569","8.45","2.392"
"Louisiana","2016","1341225","56004","14740","1.099","18.304","5782","7.762","4805","6.45","74980","3226","3306","17528","40377","97111","137488","10.251","3.01","92644","122748","30104","9.152","2.245"
"Louisiana","2017","1349331","55899","6023","0.446","21.638","5588","7.465","5503","7.351","74901","3402","3464","18169","39423","112585","152008","11.265","2.922","105419","145985","40566","10.819","3.006"
"Louisiana","2018","1356808","56276","12721","0.938","18.394","5534","7.375","4958","6.607","75324","3523","3710","18640","36675","100829","137504","10.134","2.703","92914","124783","31869","9.197","2.349"
"Maine","1978","681060","46012","42716","6.272","29.427","7545","14.321","5837","11.079","53540","3993","4040","20806","52544","90381","142925","20.986","7.715","58167","100209","42042","14.714","6.173"
"Maine","1979","725524","47058","47385","6.531","25.937","7157","13.273","5562","10.315","54721","3742","3794","18616","49053","92421","141474","19.5","6.761","56092","94089","37997","12.968","5.237"
"Maine","1980","757626","46966","10144","1.339","29.999","6440","11.79","5828","10.669","54929","4225","4273","20567","47417","76367","123784","16.338","6.259","81464","113640","32176","14.999","4.247"
"Maine","1981","762237","47382","956","0.125","30.014","6587","11.966","5414","9.835","55632","3686","3749","17501","46041","69304","115345","15.132","6.04","80351","114389","34038","15.007","4.466"
"Maine","1982","756878","46936","-5448","-0.72","30.846","6832","12.38","6425","11.642","55390","4557","4654","23840","47272","69460","116732","15.423","6.246","84770","122180","37410","16.143","4.943"
"Maine","1983","743472","48076","-11269","-1.516","32.592","6984","12.574","4874","8.775","56596","3382","3448","18287","51984","69174","121158","16.296","6.992","98024","132427","34403","17.812","4.627"
"Maine","1984","758535","49893","51735","6.82","25.01","8057","14.092","5191","9.079","58607","3789","3850","19706","50060","96528","146588","19.325","6.6","60883","94853","33970","12.505","4.478"
"Maine","1985","787898","49784","27835","3.533","28.357","7139","12.319","6071","10.476","58484","4415","4500","26059","53347","86200","139547","17.711","6.771","64357","111712","47355","14.178","6.01"
"Maine","1986","808217","49146","20244","2.505","28.858","6968","12.096","6033","10.473","58074","4389","4488","23228","54052","82811","136863","16.934","6.688","78272","116619","38347","14.429","4.745"
"Maine","1987","792987","48844","1243","0.157","35.793","7089","12.325","6302","10.956","57913","4290","4385","23888","65653","77505","143158","18.053","8.279","96384","141915","45531","17.896","5.742"
"Maine","1988","808621","50020","28488","3.523","28.715","7531","12.817","5509","9.376","59770","3913","4002","22930","62059","82525","144584","17.88","7.675","76141","116096","39955","14.357","4.941"
"Maine","1989","839606","50156","52496","6.252","27.56","6994","11.737","5851","9.819","60161","4288","4382","24137","77370","90823","168193","20.032","9.215","72803","115697","42894","13.78","5.109"
"Maine","1990","877743","50097","30860","3.516","24.886","6634","11.076","5870","9.8","60279","4343","4447","23296","49217","90860","140077","15.959","5.607","72376","109217","36841","12.443","4.197"
"Maine","1991","889221","49685","-269","-0.03","30.449","6979","11.638","6048","10.086","60431","4259","4400","28123","54681","80698","135379","15.224","6.149","90434","135648","45214","15.255","5.085"
"Maine","1992","891261","50005","15654","1.756","28.088","6718","11.137","5323","8.824","61019","3547","3612","22590","52702","88120","140822","15.8","5.913","88087","125168","37081","14.044","4.161"
"Maine","1993","903636","50985","14904","1.649","26.131","6583","10.727","5494","8.953","61911","3610","3692","20819","41491","91476","132967","14.715","4.592","79605","118063","38458","13.065","4.256"
"Maine","1994","927267","52092","29634","3.196","24.805","7077","11.316","5677","9.077","63241","3951","4108","23170","50157","94482","144639","15.598","5.409","74624","115005","40381","12.403","4.355"
"Maine","1995","957904","52951","32708","3.415","22.811","7014","11.003","5605","8.793","64449","3977","4082","21668","51083","90881","141964","14.82","5.333","72817","109256","36439","11.406","3.804"
"Maine","1996","977106","53267","26872","2.75","25.279","6960","10.79","5869","9.098","65051","4155","4264","25309","54765","95609","150374","15.39","5.605","79374","123502","44128","12.64","4.516"
"Maine","1997","1010377","53749","34772","3.441","27.295","7398","11.322","6403","9.799","65840","4197","4286","24837","64031","108631","172662","17.089","6.337","89380","137890","48510","13.647","4.801"
"Maine","1998","1060506","54426","32529","3.067","26.75","7078","10.655","6150","9.258","66892","4060","4189","24609","61963","112410","174373","16.442","5.843","87934","141844","53910","13.375","5.083"
"Maine","1999","1086279","54445","23300","2.145","27.722","6784","10.133","6209","9.274","67239","4104","4225","25055","63382","110488","173870","16.006","5.835","89997","150570","60573","13.861","5.576"
"Maine","2000","1106037","54499","17775","1.607","27.564","6789","10.091","6287","9.345","67531","4054","4152","23509","64938","105270","170208","15.389","5.871","97205","152433","55228","13.782","4.993"
"Maine","2001","1114932","54181","-9613","-0.862","26.529","6691","9.927","6567","9.743","67467","4221","4318","24369","54223","93669","147892","13.265","4.863","107197","157505","50308","14.127","4.512"
"Maine","2002","1107133","54014","-17752","-1.603","31.127","7367","10.897","7131","10.548","67721","4334","4483","32371","72056","100252","172308","15.563","6.508","128648","190060","61412","17.167","5.547"
"Maine","2003","1103696","54289","7391","0.67","27.543","6819","10.064","6269","9.253","68029","3893","3979","23324","59076","100313","159389","14.441","5.353","102822","151998","49176","13.772","4.456"
"Maine","2004","1109338","54874","5108","0.46","25.298","6768","9.919","5971","8.751","68632","3786","3871","21674","50775","94652","145427","13.109","4.577","96063","140319","44256","12.649","3.989"
"Maine","2005","1118041","55433","8836","0.79","25.606","6919","10.029","6064","8.79","69415","3976","4064","21987","51484","100495","151979","13.593","4.605","95361","143143","47782","12.803","4.274"
"Maine","2006","1141049","55574","32629","2.86","23.388","7911","11.368","6980","10.03","70056","4898","4997","24918","58972","107089","166061","14.553","5.168","88788","133432","44644","11.694","3.913"
"Maine","2007","1167964","55672","20330","1.741","25.912","7072","10.075","6360","9.061","70548","4035","4112","23459","62476","109175","171651","14.697","5.349","104264","151321","47057","12.956","4.029"
"Maine","2008","1182577","55062","12439","1.052","24.269","6084","8.671","6461","9.208","69975","4147","4250","23195","43196","112741","155937","13.186","3.653","101055","143498","42443","12.134","3.589"
"Maine","2009","1173053","54152","-35849","-3.056","21.481","5455","7.84","6381","9.17","69119","4167","4294","22227","39855","86136","125991","10.74","3.398","122340","161840","39500","13.796","3.367"
"Maine","2010","1139232","53421","-33615","-2.951","20.937","5348","7.782","5864","8.533","68465","3711","3790","20064","38485","80777","119262","10.469","3.378","110979","152877","41898","13.419","3.678"
"Maine","2011","1121653","52604","-304","-0.027","23.482","5664","8.308","5878","8.621","68072","3830","3899","19279","44988","86704","131692","11.741","4.011","94158","131996","37838","11.768","3.373"
"Maine","2012","1131264","52557","22009","1.946","21.678","5653","8.323","5524","8.134","67981","3273","3414","18220","43250","101378","144628","12.785","3.823","85067","122619","37552","10.839","3.319"
"Maine","2013","1145816","52193","12142","1.06","22.283","5382","7.947","5527","8.161","67651","3421","3454","19114","38905","100898","139803","12.201","3.395","84631","127661","43030","11.141","3.755"
"Maine","2014","1162809","52361","24276","2.088","20.627","5670","8.365","5043","7.44","68097","3242","3319","18047","47521","96682","144203","12.401","4.087","86272","119927","33655","10.314","2.894"
"Maine","2015","1180156","52369","14619","1.239","22.911","5701","8.362","5207","7.637","68426","3350","3462","18582","48448","101363","149811","12.694","4.105","98945","135192","36247","11.455","3.071"
"Maine","2016","1187170","52614","802","0.068","21.933","6015","8.745","5017","7.294","69284","3408","3543","23419","45168","85825","130993","11.034","3.805","86702","130191","43489","10.967","3.663"
"Maine","2017","1187855","52243","13832","1.164","22.861","5528","8.01","5694","8.25","68931","3706","3817","21911","46141","103467","149608","12.595","3.884","91084","135776","44692","11.43","3.762"
"Maine","2018","1197906","51951","6343","0.53","21.724","5035","7.347","5226","7.626","68432","3745","3879","21314","39211","97248","136459","11.391","3.273","94064","130116","36052","10.862","3.01"
"Maryland","1978","874035","51255","61216","7.004","28.324","8758","14.856","6970","11.823","59848","4757","4814","22023","65715","119283","184998","21.166","7.519","72360","123782","51422","14.162","5.883"
"Maryland","1979","933135","52678","50371","5.398","27.38","8433","13.921","6288","10.38","61652","4349","4380","21521","66294","111824","178118","19.088","7.104","80669","127747","47078","13.69","5.045"
"Maryland","1980","950223","52112","-12819","-1.349","29.478","7371","11.997","7009","11.408","61621","5164","5215","26418","59276","80777","140053","14.739","6.238","110402","152872","42470","16.088","4.469"
"Maryland","1981","944715","51999","-7690","-0.814","28.662","6961","11.327","6474","10.535","61698","4285","4334","21323","54903","80484","135387","14.331","5.812","100209","143077","42868","15.145","4.538"
"Maryland","1982","938542","51522","-1416","-0.151","31.803","7677","12.523","7179","11.711","61551","5143","5183","25260","68444","80796","149240","15.901","7.293","106101","150656","44555","16.052","4.747"
"Maryland","1983","929918","52050","5873","0.632","34.265","7640","12.499","6231","10.194","61829","4163","4213","23069","85230","79962","165192","17.764","9.165","102777","159319","56542","17.133","6.08"
"Maryland","1984","954629","54749","59089","6.19","23.668","9368","14.86","5384","8.54","65033","4088","4148","23094","70432","101628","172060","18.024","7.378","77344","112971","35627","11.834","3.732"
"Maryland","1985","999840","55261","46706","4.671","25.232","8388","12.956","6791","10.489","65543","4985","5076","26949","64740","108106","172846","17.287","6.475","77213","126140","48927","12.616","4.893"
"Maryland","1986","1033329","55959","34629","3.351","26.802","8685","13.255","6664","10.17","66535","4837","4888","25980","65488","107620","173108","16.752","6.338","91764","138479","46715","13.401","4.521"
"Maryland","1987","1069869","56657","-25224","-2.358","34.976","8971","13.49","6725","10.112","67626","4734","4773","27349","74027","113071","187098","17.488","6.919","156093","212322","56229","19.846","5.256"
"Maryland","1988","1076805","57939","47872","4.446","28.551","9250","13.481","6895","10.049","69792","4958","5026","29189","81553","120038","201591","18.721","7.574","95517","153719","58202","14.275","5.405"
"Maryland","1989","1121163","59052","52365","4.671","26.225","9080","12.933","6788","9.668","71356","4964","5067","29608","71568","127809","199377","17.783","6.383","90415","147012","56597","13.112","5.048"
"Maryland","1990","1169674","59919","46000","3.933","25.747","8722","12.177","6909","9.646","72531","5138","5225","30379","75620","120960","196580","16.806","6.465","100349","150580","50231","12.874","4.294"
"Maryland","1991","1190085","59480","-4664","-0.392","31.061","8574","11.826","7224","9.964","73176","5361","5456","36588","76830","107997","184827","15.531","6.456","127273","189491","62218","15.922","5.228"
"Maryland","1992","1199939","59649","25769","2.148","26.606","8124","11.132","6882","9.43","73603","4785","4864","27732","66862","118535","185397","15.451","5.572","111068","159628","48560","13.303","4.047"
"Maryland","1993","1229205","60817","37013","3.011","25.98","8358","11.285","6938","9.367","74776","4676","4793","26572","68683","128005","196688","16.001","5.588","103510","159675","56165","12.99","4.569"
"Maryland","1994","1268804","61895","34800","2.743","25.571","8307","11.003","6794","8.999","76251","4777","4881","32164","68307","128718","197025","15.528","5.384","106837","162225","55388","12.786","4.365"
"Maryland","1995","1313399","63186","58375","4.445","23.652","8760","11.371","6760","8.775","78036","4750","4853","29383","74337","139359","213696","16.27","5.66","100064","155321","55257","11.826","4.207"
"Maryland","1996","1340892","63546","14809","1.104","27.535","8665","11.073","7195","9.195","78985","5078","5200","32840","77693","121726","199419","14.872","5.794","124842","184610","59768","13.768","4.457"
"Maryland","1997","1374058","64149","49662","3.614","27.568","9066","11.424","7799","9.828","79991","5167","5322","35563","83090","155969","239059","17.398","6.047","120877","189397","68520","13.784","4.987"
"Maryland","1998","1429476","64956","35948","2.515","27.944","8812","10.925","7394","9.167","81370","4874","4976","29175","92697","142980","235677","16.487","6.485","133231","199729","66498","13.972","4.652"
"Maryland","1999","1458143","65145","26193","1.796","27.661","8502","10.425","7478","9.169","82069","5024","5186","33302","81719","146146","227865","15.627","5.604","136191","201672","65481","13.831","4.491"
"Maryland","2000","1482943","64873","43465","2.931","25.578","8123","9.912","7793","9.51","82113","4974","5111","32998","80340","152779","233119","15.72","5.418","119710","189654","69944","12.789","4.717"
"Maryland","2001","1496343","64692","-17001","-1.136","27.005","8019","9.784","7783","9.496","82081","4890","5064","32477","68719","133327","202046","13.503","4.592","148478","219047","70569","14.639","4.716"
"Maryland","2002","1475119","64519","-32921","-2.232","29.372","8809","10.699","8078","9.812","82697","4997","5141","35772","81651","134983","216634","14.686","5.535","174939","249555","74616","16.918","5.058"
"Maryland","2003","1459123","64541","2390","0.164","27.89","7928","9.587","7449","9.008","82934","4751","4892","29815","67794","138069","205863","14.109","4.646","139447","203473","64026","13.945","4.388"
"Maryland","2004","1472445","65075","17928","1.218","25.325","8036","9.663","7141","8.587","83612","4556","4706","33478","66377","138000","204377","13.88","4.508","120754","186449","65695","12.663","4.462"
"Maryland","2005","1495457","65590","21987","1.47","25.398","8400","10.003","7330","8.728","84514","4880","4987","28527","67729","144165","211894","14.169","4.529","135520","189907","54387","12.699","3.637"
"Maryland","2006","1524999","65964","38970","2.555","24.221","9327","10.978","7757","9.13","85747","5487","5578","32008","80121","143536","223657","14.666","5.254","124285","184687","60402","12.111","3.961"
"Maryland","2007","1543028","65873","-4232","-0.274","28.361","8628","10.054","7799","9.088","86234","4987","5066","31847","76280","142527","218807","14.18","4.944","160761","223039","62278","14.455","4.036"
"Maryland","2008","1536322","64823","-1548","-0.101","26.191","7458","8.7","7925","9.245","85491","5199","5302","31814","61882","139310","201192","13.096","4.028","139722","202740","63018","13.196","4.102"
"Maryland","2009","1503483","63441","-75114","-4.996","22.009","6762","7.965","8177","9.632","84188","5237","5392","32942","60131","105318","165449","11.004","3.999","178275","240563","62288","16.0","4.143"
"Maryland","2010","1451851","62503","-26875","-1.851","22.638","6684","7.983","7191","8.589","83472","4606","4751","27530","55325","109008","164333","11.319","3.811","142005","191208","49203","13.17","3.389"
"Maryland","2011","1441506","61684","8638","0.599","22.716","6703","8.067","6976","8.395","82956","4641","4796","27913","50043","122321","172364","11.957","3.472","113941","163726","49785","11.358","3.454"
"Maryland","2012","1461244","61609","32939","2.254","22.328","6961","8.401","6616","7.984","83035","4034","4177","22143","57155","138920","196075","13.418","3.911","114028","163136","49108","11.164","3.361"
"Maryland","2013","1489220","61728","22086","1.483","22.894","7315","8.804","6695","8.058","83398","4168","4234","24440","62806","129750","192556","12.93","4.217","118519","170470","51951","11.447","3.488"
"Maryland","2014","1515341","62261","31962","2.109","21.918","7755","9.248","6425","7.662","84518","4133","4232","23256","66394","131637","198031","13.068","4.381","120692","166069","45377","10.959","2.995"
"Maryland","2015","1554741","62234","46398","2.984","19.3","7242","8.55","6366","7.515","85143","4134","4203","22482","56784","139645","196429","12.634","3.652","106650","150031","43381","9.65","2.79"
"Maryland","2016","1592375","62274","29594","1.858","20.179","6974","8.173","6239","7.312","85697","4248","4436","24163","57297","132958","190255","11.948","3.598","114303","160661","46358","10.089","2.911"
"Maryland","2017","1611639","61828","22039","1.367","22.862","6801","7.97","7078","8.294","85198","4698","4761","31071","60556","145706","206262","12.798","3.757","121825","184223","62398","11.431","3.872"
"Maryland","2018","1632447","60775","21082","1.291","20.549","6078","7.229","6190","7.362","84019","4337","4504","29416","56282","132528","188810","11.566","3.448","117657","167728","50071","10.275","3.067"
"Massachusetts","1978","1083373","61342","138578","12.791","28.529","11377","16.009","8327","11.717","72593","5708","5772","28271","104999","188118","293117","27.056","9.692","93368","154539","61171","14.265","5.646"
"Massachusetts","1979","1192552","63766","79151","6.637","30.67","11452","15.552","7585","10.3","75572","5309","5366","34629","93369","168660","262029","21.972","7.829","114419","182878","68459","15.335","5.741"
"Massachusetts","1980","1238380","64204","16639","1.344","34.101","10431","13.792","8593","11.362","76550","6256","6332","36440","80948","146840","227788","18.394","6.537","147257","211149","63892","17.05","5.159"
"Massachusetts","1981","1275262","66188","68945","5.406","28.917","11096","14.329","7691","9.932","79141","5151","5239","27875","87490","165839","253329","19.865","6.861","126996","184384","57388","14.459","4.5"
"Massachusetts","1982","1318061","67895","25552","1.939","36.415","11906","14.894","8838","11.056","81470","6338","6416","38461","107144","158396","265540","20.146","8.129","163562","239988","76426","18.208","5.798"
"Massachusetts","1983","1274663","69705","-78952","-6.194","33.83","11233","13.772","8008","9.818","83179","5697","5780","37478","82161","133447","215608","16.915","6.446","223267","294560","71293","23.109","5.593"
"Massachusetts","1984","1247031","71684","43488","3.487","31.76","12558","15.004","8710","10.407","85619","6404","6518","34242","94337","147180","241517","19.367","7.565","134365","198029","63664","15.88","5.105"
"Massachusetts","1985","1259423","71297","16075","1.276","35.348","11522","13.619","10264","12.132","85229","7591","7736","50763","95273","143394","238667","18.951","7.565","142094","222592","80498","17.674","6.392"
"Massachusetts","1986","1249513","69695","-12149","-0.972","36.077","10948","13.072","10349","12.357","84050","7788","7902","43865","95328","130067","225395","18.039","7.629","165164","237544","72380","19.011","5.793"
"Massachusetts","1987","1207653","66402","-64096","-5.307","34.959","10102","12.418","11756","14.451","80524","8117","8256","53178","95124","115966","211090","17.479","7.877","171477","275186","103709","22.787","8.588"
"Massachusetts","1988","1178352","66121","22168","1.881","34.002","10561","13.084","9572","11.858","81213","6717","6875","42008","87436","135063","222499","18.882","7.42","128111","200331","72220","17.001","6.129"
"Massachusetts","1989","1199435","65327","40243","3.355","30.875","9417","11.749","8869","11.065","80426","6267","6452","43516","81116","144289","225405","18.793","6.763","114236","185162","70926","15.437","5.913"
"Massachusetts","1990","1244486","65770","64368","5.172","27.355","9655","12.028","7889","9.828","81153","5680","5825","37659","81032","153548","234580","18.85","6.511","109672","170212","60540","13.677","4.865"
"Massachusetts","1991","1284579","65778","30425","2.368","31.271","9968","12.282","7913","9.75","82185","5621","5781","43691","90276","140999","231275","18.004","7.028","130596","200850","70254","15.635","5.469"
"Massachusetts","1992","1298293","66349","23979","1.847","31.888","9375","11.447","7616","9.299","82779","5003","5124","37096","78409","152569","230978","17.791","6.039","139896","206999","67103","15.944","5.169"
"Massachusetts","1993","1317733","67983","19434","1.475","31.023","9371","11.233","7644","9.163","84289","5172","5271","38717","73524","150312","223836","16.986","5.58","136199","204402","68203","15.512","5.176"
"Massachusetts","1994","1357169","69520","56781","4.184","27.709","10135","11.885","8019","9.404","86334","5551","5776","40083","93630","151180","244810","18.038","6.899","125774","188029","62255","13.855","4.587"
"Massachusetts","1995","1395710","70777","36545","2.618","29.586","9843","11.313","8018","9.216","87916","5544","5771","40588","92199","150815","243014","17.411","6.606","126889","206469","79580","14.793","5.702"
"Massachusetts","1996","1422590","71807","40440","2.843","27.674","9807","11.098","7849","8.882","89344","5528","5655","36367","81013","156269","237282","16.68","5.695","133323","196842","63519","13.837","4.465"
"Massachusetts","1997","1462287","72603","33711","2.305","31.884","10340","11.518","9012","10.039","90435","5984","6155","41317","91302","175524","266826","18.247","6.244","148620","233115","84495","15.942","5.778"
"Massachusetts","1998","1540752","73463","52322","3.396","28.822","9810","10.778","8705","9.564","91572","5679","5871","41748","94270","180089","274359","17.807","6.118","145199","222037","76838","14.411","4.987"
"Massachusetts","1999","1571730","73264","4664","0.297","30.421","9378","10.243","8792","9.603","91848","5852","6073","48788","81172","162561","243733","15.507","5.165","153234","239069","85835","15.211","5.461"
"Massachusetts","2000","1582667","72808","17159","1.084","31.1","9438","10.296","9237","10.076","91771","5804","6022","49734","103201","160062","263263","16.634","6.521","153709","246104","92395","15.55","5.838"
"Massachusetts","2001","1590928","72647","-1681","-0.106","30.073","9372","10.231","9025","9.852","91776","5486","5670","39712","81874","157345","239219","15.036","5.146","163289","240900","77611","15.142","4.878"
"Massachusetts","2002","1585941","73105","-25837","-1.629","32.638","10167","11.022","9088","9.852","92781","5554","5797","49777","103570","155239","258809","16.319","6.531","187471","284646","97175","17.948","6.127"
"Massachusetts","2003","1584733","73731","24786","1.564","28.641","9241","9.947","8374","9.014","93338","5279","5387","37227","82804","168920","251724","15.884","5.225","154341","226938","72597","14.32","4.581"
"Massachusetts","2004","1604877","74453","16243","1.012","27.389","9094","9.711","7986","8.528","94198","5174","5298","34601","69200","166825","236025","14.707","4.312","154882","219782","64900","13.695","4.044"
"Massachusetts","2005","1611222","74685","-8051","-0.5","29.869","9322","9.88","8608","9.124","94705","5602","5774","42464","74977","165648","240625","14.934","4.653","159186","248676","89490","15.434","5.554"
"Massachusetts","2006","1595008","72038","-19770","-1.239","34.832","10847","11.618","12686","13.588","92445","7757","7917","47644","101559","176231","277790","17.416","6.367","196724","297560","100836","18.656","6.322"
"Massachusetts","2007","1610304","74811","50745","3.151","28.975","11778","12.534","7959","8.47","95877","4894","4975","31335","92137","191897","284034","17.639","5.722","166499","233289","66790","14.487","4.148"
"Massachusetts","2008","1633522","74836","4702","0.288","28.419","9251","9.646","8574","8.94","96243","5540","5631","31956","71686","165134","236820","14.498","4.388","165918","232118","66200","14.21","4.053"
"Massachusetts","2009","1636373","74554","-14212","-0.869","25.966","8436","8.763","8634","8.968","96173","5649","5744","37118","70575","141878","212453","12.983","4.313","161476","226665","65189","13.852","3.984"
"Massachusetts","2010","1610727","74065","-37662","-2.338","23.102","8142","8.482","7993","8.327","96065","5148","5293","32583","67094","118964","186058","11.551","4.165","169156","223720","54564","13.889","3.388"
"Massachusetts","2011","1600259","73731","18535","1.158","23.755","8439","8.785","7884","8.207","96338","5145","5300","26581","67663","140939","208602","13.036","4.228","140644","190067","49423","11.877","3.088"
"Massachusetts","2012","1619286","74017","27673","1.709","24.009","8536","8.854","7772","8.062","96788","4683","4850","28799","64519","157543","222062","13.714","3.984","138967","194389","55422","12.005","3.423"
"Massachusetts","2013","1651367","74035","40465","2.45","24.147","8077","8.357","7701","7.968","96843","4799","4875","36239","72398","167445","239843","14.524","4.384","126099","199378","73279","12.074","4.437"
"Massachusetts","2014","1689244","74116","30564","1.809","21.584","8211","8.46","7311","7.533","97502","4757","4853","27902","68057","144806","212863","12.601","4.029","127828","182299","54471","10.792","3.225"
"Massachusetts","2015","1709760","73996","12269","0.718","24.975","8372","8.576","7603","7.788","98008","4933","5031","29126","74740","151033","225773","13.205","4.371","158953","213504","54551","12.487","3.191"
"Massachusetts","2016","1708276","73953","-14819","-0.867","23.349","8545","8.695","7513","7.645","98793","5201","5324","32490","71968","127467","199435","11.675","4.213","159788","214254","54466","12.542","3.188"
"Massachusetts","2017","1689904","73679","-14783","-0.875","24.843","7802","7.928","8078","8.208","98273","5110","5224","30774","59209","150705","209914","12.422","3.504","160626","224697","64071","13.296","3.791"
"Massachusetts","2018","1687462","73624","5493","0.326","22.964","7654","7.815","7760","7.923","97892","5515","5828","34516","55536","143711","199247","11.807","3.291","137368","193754","56386","11.482","3.341"
"Michigan","1978","297382","19754","21894","7.362","24.644","3348","15.195","2365","10.734","22525","1651","1672","7049","20682","37856","58538","19.684","6.955","21603","36644","15041","12.322","5.058"
"Michigan","1979","307943","20268","15759","5.118","24.781","3051","13.411","2219","9.754","23166","1571","1580","6387","19778","34137","53915","17.508","6.423","25188","38156","12968","12.391","4.211"
"Michigan","1980","321010","19985","-3324","-1.035","29.999","2637","11.487","2706","11.788","22921","1819","1841","8639","17413","30737","48150","15.0","5.424","35505","51474","15969","16.035","4.975"
"Michigan","1981","317642","19936","-2017","-0.635","28.415","2546","11.15","2340","10.247","22938","1585","1600","5748","15275","29854","45129","14.208","4.809","30531","47146","16615","14.843","5.231"
"Michigan","1982","318706","19722","5288","1.659","29.888","2737","12.005","2584","11.334","22875","1797","1819","8083","21042","31873","52915","16.603","6.602","31057","47627","16570","14.944","5.199"
"Michigan","1983","322507","20136","7526","2.334","27.784","2891","12.624","2037","8.895","23327","1352","1372","6830","17869","34460","52329","16.226","5.541","30155","44803","14648","13.892","4.542"
"Michigan","1984","334396","21542","23715","7.092","19.961","3597","15.017","1816","7.582","24843","1280","1307","5954","18856","38234","57090","17.073","5.639","22498","33375","10877","9.981","3.253"
"Michigan","1985","348244","22344","7631","2.191","30.464","3561","14.199","2447","9.757","25636","1673","1701","8938","23473","37203","60676","17.423","6.74","31029","53045","22016","15.232","6.322"
"Michigan","1986","356710","23292","17437","4.888","26.492","3980","15.33","2529","9.741","26687","1766","1812","10266","24078","40609","64687","18.134","6.75","29657","47250","17593","13.246","4.932"
"Michigan","1987","387626","24603","3329","0.859","37.318","4519","16.522","2694","9.85","28264","1933","1958","10295","31758","43898","75656","19.518","8.193","53888","72327","18439","18.659","4.757"
"Michigan","1988","404075","25980","23589","5.838","26.193","4571","15.739","2839","9.775","29908","2056","2070","10533","25677","50831","76508","18.934","6.355","35255","52919","17664","13.096","4.371"
"Michigan","1989","426975","26850","15374","3.601","29.641","4470","14.761","3082","10.177","30977","2329","2384","13260","29273","49381","78654","18.421","6.856","41837","63280","21443","14.821","5.022"
"Michigan","1990","426882","26386","-9016","-2.112","28.714","3498","11.416","3564","11.631","30608","2748","2792","14724","25063","36224","61287","14.357","5.871","49571","70303","20732","16.469","4.857"
"Michigan","1991","411199","25576","-19856","-4.829","25.602","3362","11.133","3532","11.696","30113","2558","2588","14454","21902","30735","52637","12.801","5.326","49132","72493","23361","17.63","5.681"
"Michigan","1992","395345","25346","-1679","-0.425","28.553","3209","10.761","3079","10.325","29886","2040","2080","10262","20726","35715","56441","14.276","5.243","39281","58120","18839","14.701","4.765"
"Michigan","1993","400737","25660","12664","3.16","25.34","3324","11.106","3048","10.183","30069","1968","2022","9494","21718","41719","63437","15.83","5.42","33331","50773","17442","12.67","4.352"
"Michigan","1994","412838","26117","9344","2.263","25.183","3551","11.699","2897","9.544","30680","2065","2106","12069","21450","39876","61326","14.855","5.196","33108","51982","18874","12.591","4.572"
"Michigan","1995","424716","26753","15282","3.598","21.832","3651","11.789","2877","9.29","31356","2006","2047","9770","20112","41531","61643","14.514","4.735","31295","46361","15066","10.916","3.547"
"Michigan","1996","431658","27157","5102","1.182","25.447","3699","11.747","3023","9.6","31827","2111","2133","11219","22691","37332","60023","13.905","5.257","36078","54921","18843","12.723","4.365"
"Michigan","1997","438099","27585","11647","2.659","26.051","3822","11.912","3134","9.768","32428","2097","2143","11537","24773","43938","68711","15.684","5.655","35540","57064","21524","13.025","4.913"
"Michigan","1998","454636","28251","12377","2.722","24.211","3782","11.526","2978","9.076","33215","1989","2020","9849","22960","44452","67412","14.828","5.05","36167","55035","18868","12.105","4.15"
"Michigan","1999","466339","28818","12210","2.618","24.352","3694","11.028","2942","8.783","33874","1992","2043","11252","22956","46036","68992","14.794","4.923","38190","56782","18592","12.176","3.987"
"Michigan","2000","481677","29183","17124","3.555","22.859","3597","10.551","2950","8.653","34415","1996","2043","10610","23507","48670","72177","14.985","4.88","34240","55053","20813","11.429","4.321"
"Michigan","2001","493246","29292","6919","1.403","25.741","3620","10.499","3113","9.028","34734","2107","2139","11062","28018","42385","70403","14.273","5.68","42142","63484","21342","12.871","4.327"
"Michigan","2002","494778","29176","-14976","-3.027","28.357","3877","11.137","3604","10.353","34949","2244","2280","17290","28981","41172","70153","14.179","5.857","55494","85129","29635","17.206","5.99"
"Michigan","2003","486805","29479","1959","0.402","26.79","3648","10.411","3083","8.799","35321","1933","1981","11025","23358","43808","67166","13.797","4.798","43548","65207","21659","13.395","4.449"
"Michigan","2004","490860","29940","7244","1.476","21.853","3662","10.311","3013","8.484","35840","2039","2076","11053","18983","41894","60877","12.402","3.867","35565","53633","18068","10.926","3.681"
"Michigan","2005","495714","30292","3391","0.684","23.814","3754","10.416","3086","8.562","36376","2045","2063","9646","21727","40689","62416","12.591","4.383","41874","59025","17151","11.907","3.46"
"Michigan","2006","501784","30657","8177","1.63","23.016","4282","11.683","3425","9.345","37079","2463","2488","10848","25707","40216","65923","13.138","5.123","39190","57746","18556","11.508","3.698"
"Michigan","2007","502823","30709","-4905","-0.975","26.51","3929","10.583","3453","9.301","37362","2294","2310","13173","23547","43103","66650","13.255","4.683","45418","71555","26137","14.231","5.198"
"Michigan","2008","503170","30098","5692","1.131","23.839","3413","9.228","3804","10.285","36790","2495","2543","11451","20534","45134","65668","13.051","4.081","40369","59976","19607","11.92","3.897"
"Michigan","2009","497706","28973","-19757","-3.97","20.535","2876","7.941","3920","10.823","35697","2447","2470","11670","17680","33421","51101","10.267","3.552","50937","70858","19921","14.237","4.003"
"Michigan","2010","483972","28759","-8244","-1.703","20.797","3153","8.865","3194","8.981","35545","1935","1970","8468","17880","32446","50326","10.399","3.694","42233","58570","16337","12.102","3.376"
"Michigan","2011","478807","28335","-1012","-0.211","22.104","3107","8.805","3332","9.442","35175","1969","2062","10152","16986","35932","52918","11.052","3.548","36361","53930","17569","11.263","3.669"
"Michigan","2012","480900","28232","5903","1.227","21.034","3168","9.035","3107","8.861","35094","1840","1915","8726","16814","39666","56480","11.745","3.496","35088","50577","15489","10.517","3.221"
"Michigan","2013","484245","28117","-1179","-0.243","22.342","3039","8.686","2964","8.471","35026","1706","1739","9396","15832","38264","54096","11.171","3.269","35811","55275","19464","11.415","4.019"
"Michigan","2014","486915","28205","6893","1.416","19.999","3121","8.895","2757","7.857","35270","1681","1709","6911","20298","35285","55583","11.415","4.169","34465","48690","14225","10.0","2.921"
"Michigan","2015","494727","28401","10027","2.027","19.31","3169","8.957","2720","7.688","35606","1721","1752","7510","17541","40252","57793","11.682","3.546","32242","47766","15524","9.655","3.138"
"Michigan","2016","505043","29083","10441","2.067","18.432","3435","9.549","2492","6.928","36442","1682","1721","8674","19280","37705","56985","11.283","3.817","31535","46544","15009","9.216","2.972"
"Michigan","2017","510725","29109","3654","0.715","21.417","3014","8.287","2896","7.963","36428","1894","1935","9184","15268","43076","58344","11.424","2.989","37014","54690","17676","10.708","3.461"
"Michigan","2018","514469","29262","4125","0.802","19.882","2791","7.673","2679","7.365","36429","1927","1983","9626","14025","41243","55268","10.743","2.726","36752","51143","14391","9.941","2.797"
"Minnesota","1978","1158306","60009","72800","6.285","27.761","9685","13.772","7531","10.709","71403","4862","4958","27639","77146","156434","233580","20.166","6.66","96942","160780","63838","13.881","5.511"
"Minnesota","1979","1213827","61980","67116","5.529","26.138","9675","13.359","6625","9.148","73947","4402","4467","23659","72131","153617","225748","18.598","5.942","99087","158632","59545","13.069","4.906"
"Minnesota","1980","1263456","62574","27045","2.141","29.7","9036","12.201","7341","9.912","74910","4953","5052","27520","75323","139342","214665","16.99","5.962","134240","187620","53380","14.85","4.225"
"Minnesota","1981","1283993","63077","15051","1.172","28.993","8645","11.506","6929","9.222","75991","4394","4501","21926","74238","126946","201184","15.669","5.782","136746","186133","49387","14.496","3.846"
"Minnesota","1982","1296756","63141","16418","1.266","32.479","9456","12.451","8123","10.696","76613","5340","5449","29567","97961","129041","227002","17.505","7.554","149196","210584","61388","16.239","4.734"
"Minnesota","1983","1301928","65969","38110","2.927","28.655","10355","13.346","6259","8.067","79637","4141","4227","24227","75452","149192","224644","17.255","5.795","133899","186534","52635","14.328","4.043"
"Minnesota","1984","1367734","68422","109419","8.0","23.467","11165","13.853","7159","8.883","82599","4969","5054","26919","94397","175508","269905","19.734","6.902","108728","160486","51758","11.734","3.784"
"Minnesota","1985","1467932","70991","118360","8.063","26.94","12704","15.182","8938","10.682","85559","6418","6566","46658","124976","191112","316088","21.533","8.514","120354","197728","77374","13.47","5.271"
"Minnesota","1986","1553757","73944","81155","5.223","29.382","12766","14.741","7805","9.013","89080","5335","5436","36173","114826","194594","309420","19.914","7.39","156313","228265","71952","14.691","4.631"
"Minnesota","1987","1628501","76598","90287","5.544","30.54","13530","14.96","8760","9.686","92829","5942","6045","42489","136503","202460","338963","20.814","8.382","163930","248676","84746","15.27","5.204"
"Minnesota","1988","1715339","80084","72259","4.213","30.633","14296","15.013","9024","9.477","97861","6292","6423","44375","136401","198585","334986","19.529","7.952","180314","262727","82413","15.316","4.804"
"Minnesota","1989","1769552","82591","58556","3.309","29.874","13844","13.986","9295","9.39","101259","6441","6570","44808","123434","199436","322870","18.246","6.975","176113","264314","88201","14.937","4.984"
"Minnesota","1990","1817815","84731","54341","2.989","28.78","13348","13.076","9426","9.234","104043","6736","6895","49144","111740","204184","315924","17.379","6.147","180993","261583","80590","14.39","4.433"
"Minnesota","1991","1788478","83733","-81831","-4.575","28.492","12703","12.277","11132","10.759","104254","7809","7946","57849","107979","146807","254786","14.246","6.037","232618","336617","103999","18.821","5.815"
"Minnesota","1992","1730658","83957","-10612","-0.613","31.816","12054","11.61","10462","10.077","104618","6714","6890","42402","101418","173893","275311","15.908","5.86","200600","285923","85323","16.521","4.93"
"Minnesota","1993","1728687","85617","11213","0.649","31.169","12262","11.692","11149","10.631","105432","6717","6929","43632","102030","178588","280618","16.233","5.902","180690","269405","88715","15.584","5.132"
"Minnesota","1994","1746573","87079","14522","0.831","30.5","12324","11.596","10482","9.863","107196","6984","7184","48898","96726","184146","280872","16.081","5.538","170429","266350","95921","15.25","5.492"
"Minnesota","1995","1783818","89169","72391","4.058","25.533","13125","12.12","10335","9.543","109691","7015","7227","45457","104081","196040","300121","16.825","5.835","144863","227730","82867","12.766","4.645"
"Minnesota","1996","1804839","89527","5037","0.279","30.067","12272","11.196","10923","9.965","110285","7319","7495","47844","103277","173089","276366","15.313","5.722","180550","271329","90779","15.033","5.03"
"Minnesota","1997","1850111","90275","70349","3.802","31.05","13541","12.235","12226","11.047","111332","7830","8076","50170","135481","222096","357577","19.327","7.323","178129","287228","109099","15.525","5.897"
"Minnesota","1998","1921868","91176","49144","2.557","28.965","12539","11.208","11540","10.315","112370","7105","7377","47642","120458","207023","327481","17.04","6.268","175057","278337","103280","14.483","5.374"
"Minnesota","1999","1959877","91750","37170","1.897","29.78","12225","10.857","11083","9.843","113172","6972","7119","50988","116570","212429","328999","16.787","5.948","185490","291829","106339","14.89","5.426"
"Minnesota","2000","2028505","92041","71934","3.546","27.562","12063","10.635","11082","9.77","113914","6909","7081","41588","114494","236990","351484","17.327","5.644","175864","279550","103686","13.781","5.111"
"Minnesota","2001","2073269","92803","15901","0.767","29.9","12759","11.162","11247","9.839","115062","6707","7080","49209","121782","204076","325858","15.717","5.874","204955","309957","105002","14.95","5.065"
"Minnesota","2002","2077546","93760","-35041","-1.687","32.148","14086","12.147","12143","10.472","116933","7044","7290","65063","134973","198967","333940","16.074","6.497","238811","368981","130170","17.76","6.266"
"Minnesota","2003","2067689","95389","17232","0.833","28.35","12879","10.95","11118","9.453","118498","6580","6755","37806","102052","208276","310328","15.008","4.936","205514","293096","87582","14.175","4.236"
"Minnesota","2004","2110045","97377","62772","2.975","24.988","13235","11.073","10850","9.078","120714","6708","6833","40409","105264","221137","326401","15.469","4.989","169122","263629","94507","12.494","4.479"
"Minnesota","2005","2168711","99419","-16291","-0.751","28.24","14076","11.551","11485","9.425","123158","7110","7228","47458","110640","195585","306225","14.12","5.102","228234","322516","94282","14.871","4.347"
"Minnesota","2006","2197899","101592","69500","3.162","25.555","15847","12.708","12282","9.849","126482","8338","8473","48704","130805","219527","350332","15.939","5.951","182077","280832","98755","12.777","4.493"
"Minnesota","2007","2232594","101869","-662","-0.03","29.378","14006","11.05","12780","10.083","127365","7986","8106","45461","107431","220513","327944","14.689","4.812","228208","328606","100398","14.719","4.497"
"Minnesota","2008","2225864","100141","-5121","-0.23","27.415","12091","9.563","13458","10.644","125758","8559","8711","43265","93139","211966","305105","13.707","4.184","206605","310226","103621","13.937","4.655"
"Minnesota","2009","2175819","97137","-106330","-4.887","23.137","11122","8.929","14042","11.274","123095","8587","8727","47550","93780","157934","251714","11.569","4.31","241998","358044","116046","16.456","5.333"
"Minnesota","2010","2096282","95778","-47591","-2.27","23.298","11194","9.159","12412","10.155","121612","7327","7608","42103","80744","163452","244196","11.649","3.852","208550","291787","83237","13.919","3.971"
"Minnesota","2011","2090663","94966","33183","1.587","22.977","11480","9.46","11515","9.489","121339","7196","7312","36518","85784","187585","273369","13.076","4.103","165485","240186","74701","11.489","3.573"
"Minnesota","2012","2126113","95805","36834","1.732","23.083","11456","9.423","10353","8.516","122127","5964","6119","32611","81471","200746","282217","13.274","3.832","170820","245383","74563","11.541","3.507"
"Minnesota","2013","2159562","95959","32003","1.482","23.122","11507","9.41","10622","8.687","122722","6257","6414","44000","91542","190125","281667","13.043","4.239","168158","249664","81506","11.561","3.774"
"Minnesota","2014","2188942","96171","29340","1.34","21.094","11698","9.498","10413","8.454","123811","6460","6531","32474","79015","181196","260211","11.888","3.61","166801","230871","64070","10.547","2.927"
"Minnesota","2015","2217155","96337","28801","1.299","21.629","11252","9.079","10503","8.475","124310","6502","6622","35247","90809","177767","268576","12.114","4.096","166588","239775","73187","10.815","3.301"
"Minnesota","2016","2254669","97434","45283","2.008","19.962","11796","9.42","9550","7.626","126348","6316","6444","34982","83136","187185","270321","11.989","3.687","154954","225038","70084","9.981","3.108"
"Minnesota","2017","2301437","97533","53308","2.316","22.487","11043","8.747","10837","8.584","126353","6845","6967","39339","85961","226106","312067","13.56","3.735","177717","258759","81042","11.243","3.521"
"Minnesota","2018","2344212","97792","33958","1.449","21.092","10662","8.442","10373","8.214","126435","7275","7464","41680","80243","200937","281180","11.995","3.423","173234","247222","73988","10.546","3.156"
"Mississippi","1978","1972558","95939","153303","7.772","24.569","13323","12.143","10891","9.927","110930","6989","7111","39564","121652","273967","395619","20.056","6.167","136887","242316","105429","12.284","5.345"
"Mississippi","1979","2119358","97515","136263","6.429","23.566","12864","11.529","10039","8.997","112995","6233","6324","36887","120881","265104","385985","18.212","5.704","160083","249722","89639","11.783","4.23"
"Mississippi","1980","2217330","97713","54578","2.461","26.109","12021","10.637","10475","9.269","113780","6958","7099","40028","109349","234685","344034","15.516","4.932","200366","289456","89090","13.054","4.018"
"Mississippi","1981","2265380","99266","46555","2.055","27.239","12081","10.553","9080","7.932","115977","5408","5548","43392","118677","236410","355087","15.675","5.239","213948","308532","94584","13.619","4.175"
"Mississippi","1982","2305606","100178","18998","0.824","28.052","13164","11.314","10720","9.213","117575","7220","7337","44573","132729","209656","342385","14.85","5.757","235563","323387","87824","14.026","3.809"
"Mississippi","1983","2317616","102851","39091","1.687","28.039","13653","11.535","9262","7.826","120552","6206","6314","42015","136503","227501","364004","15.706","5.89","238049","324913","86864","14.019","3.748"
"Mississippi","1984","2414167","107703","188717","7.817","21.531","15450","12.609","8783","7.168","125869","6139","6230","38304","151815","296802","448617","18.583","6.289","186821","259900","73079","10.766","3.027"
"Mississippi","1985","2551069","110961","127288","4.99","25.99","16341","12.863","11151","8.777","129637","8014","8188","63782","132770","326027","458797","17.985","5.204","219520","331509","111989","12.995","4.39"
"Mississippi","1986","2627081","113874","73823","2.81","28.632","17225","13.203","11818","9.059","133163","8292","8459","62076","158725","291189","449914","17.126","6.042","266989","376091","109102","14.316","4.153"
"Mississippi","1987","2710671","117384","60766","2.242","31.076","18927","14.054","12962","9.624","137660","9026","9167","67907","187081","294872","481953","17.78","6.902","293094","421187","128093","15.538","4.726"
"Mississippi","1988","2781077","121947","71037","2.554","29.342","19170","13.655","13130","9.353","143407","9057","9223","64462","171551","307503","479054","17.225","6.169","282949","408017","125068","14.671","4.497"
"Mississippi","1989","2835161","123505","65358","2.305","29.744","18080","12.558","13789","9.578","146114","10235","10397","71923","175736","311266","487002","17.177","6.198","292432","421644","129212","14.872","4.557"
"Mississippi","1990","2832193","120599","-90779","-3.205","27.141","15361","10.644","16083","11.144","143954","11968","12207","75514","150115","234232","384347","13.571","5.3","336105","475126","139021","16.776","4.909"
"Mississippi","1991","2675225","115186","-173319","-6.479","24.366","14486","10.292","16836","11.961","139577","11797","12170","99910","129581","196338","325919","12.183","4.844","339585","499238","159653","18.662","5.968"
"Mississippi","1992","2561735","113155","-8461","-0.33","28.903","13675","9.933","14224","10.332","137396","9210","9434","61190","131230","238982","370212","14.452","5.123","261353","378673","117320","14.782","4.58"
"Mississippi","1993","2576393","114152","49690","1.929","27.902","14252","10.358","13204","9.596","138120","8532","8908","55784","135504","273624","409128","15.88","5.259","243193","359438","116245","13.951","4.512"
"Mississippi","1994","2624957","116138","30263","1.153","27.899","15103","10.84","12618","9.056","140575","8391","8577","58059","129775","266654","396429","15.102","4.944","242310","366166","123856","13.949","4.718"
"Mississippi","1995","2671039","118601","75954","2.844","25.12","16105","11.339","12565","8.847","143800","8410","8856","63829","139762","271678","411440","15.404","5.232","219073","335486","116413","12.56","4.358"
"Mississippi","1996","2691233","119363","28403","1.055","26.85","15154","10.536","13073","9.089","144870","8588","8901","66269","128111","261595","389706","14.481","4.76","221097","361304","140207","13.425","5.21"
"Mississippi","1997","2748805","121508","78179","2.844","27.952","16335","11.184","13498","9.242","147471","8679","8905","67671","171587","290771","462358","16.82","6.242","249660","384179","134519","13.976","4.894"
"Mississippi","1998","2845354","123372","66655","2.343","27.252","15031","10.111","12973","8.727","149687","8078","8265","53140","147928","306428","454356","15.968","5.199","257804","387701","129897","13.626","4.565"
"Mississippi","1999","2905946","125605","54211","1.866","27.106","16092","10.672","13166","8.732","152250","8348","8618","60919","145174","302882","448056","15.419","4.996","263955","393845","129890","13.553","4.47"
"Mississippi","2000","2990220","127038","99297","3.321","26.52","15776","10.3","13399","8.748","154354","8367","8750","62476","156661","339140","495801","16.581","5.239","246458","396504","150046","13.26","5.018"
"Mississippi","2001","3064926","127270","62099","2.026","27.673","15396","9.964","14048","9.091","155198","8871","9095","70000","157784","328389","486173","15.862","5.148","283552","424074","140522","13.836","4.585"
"Mississippi","2002","3048294","126587","-130938","-4.295","29.822","16606","10.685","15927","10.249","155747","9918","10170","97677","173281","281251","454532","14.911","5.685","382239","585470","203231","19.206","6.667"
"Mississippi","2003","2974590","128756","-23620","-0.794","28.101","16884","10.783","14612","9.332","157714","8581","8746","56000","130111","287835","417946","14.051","4.374","285312","441566","156254","14.845","5.253"
"Mississippi","2004","2968394","127597","4163","0.14","25.618","15496","9.86","16263","10.348","156779","11366","11527","59227","130393","253993","384386","12.949","4.393","258690","380223","121533","12.809","4.094"
"Mississippi","2005","2981468","126895","19063","0.639","24.026","15388","9.826","15242","9.733","156676","10082","10245","53757","125938","251284","377222","12.652","4.224","237934","358159","120225","12.013","4.032"
"Mississippi","2006","3026483","128547","70434","2.327","24.197","17146","10.86","14110","8.937","159407","9374","9531","57690","149926","286665","436591","14.426","4.954","250098","366157","116059","12.098","3.835"
"Mississippi","2007","3060142","127910","12054","0.394","26.052","15439","9.697","15102","9.485","159388","9372","9538","52142","125897","284765","410662","13.42","4.114","277914","398608","120694","13.026","3.944"
"Mississippi","2008","3063213","125864","2982","0.097","25.577","13749","8.679","15132","9.552","157722","9661","9814","53371","118607","276118","394725","12.886","3.872","268881","391743","122862","12.789","4.011"
"Mississippi","2009","3016304","122738","-107436","-3.562","21.118","12364","7.913","15821","10.126","154511","9536","9761","62149","108579","209910","318489","10.559","3.6","310026","425925","115899","14.121","3.842"
"Mississippi","2010","2947163","121196","-30139","-1.023","21.876","13245","8.612","14155","9.203","153348","8427","8637","45915","102477","219888","322365","10.938","3.477","257894","352504","94610","11.961","3.21"
"Mississippi","2011","2950189","121077","37415","1.268","20.072","13416","8.746","12885","8.4","153665","7692","7822","40049","90399","243095","333494","11.304","3.064","214301","296079","81778","10.036","2.772"
"Mississippi","2012","3000529","122509","61431","2.047","19.676","13973","9.069","12489","8.106","154815","7136","7356","44259","88773","267856","356629","11.886","2.959","199175","295198","96023","9.838","3.2"
"Mississippi","2013","3055518","122948","49178","1.609","19.496","13715","8.85","12713","8.203","155475","7507","7655","40393","99759","247268","347027","11.357","3.265","203943","297849","93906","9.748","3.073"
"Mississippi","2014","3077930","123708","23242","0.755","20.561","13526","8.671","11999","7.692","156754","7590","7801","42180","107513","232158","339671","11.036","3.493","234774","316429","81655","10.281","2.653"
"Mississippi","2015","3131739","124299","85540","2.731","18.327","13696","8.715","12442","7.917","157785","7709","7857","44992","112099","260418","372517","11.895","3.579","196664","286977","90313","9.164","2.884"
"Mississippi","2016","3204223","126526","65142","2.033","19.062","15046","9.437","11401","7.151","161264","7837","7981","45567","107636","262908","370544","11.564","3.359","224089","305402","81313","9.531","2.538"
"Mississippi","2017","3274276","127187","37004","1.13","22.04","14117","8.735","12979","8.031","162183","8362","8575","54662","112405","285432","397837","12.15","3.433","250655","360833","110178","11.02","3.365"
"Mississippi","2018","3316954","127751","70545","2.127","20.088","13290","8.194","12792","7.887","162447","9030","9228","50899","125365","278340","403705","12.171","3.78","233028","333160","100132","10.044","3.019"
"Missouri","1978","2807821","127248","231579","8.248","23.186","20774","13.918","15910","10.659","151689","10389","10577","61361","176085","380998","557083","19.84","6.271","175782","325504","149722","11.593","5.332"
"Missouri","1979","2925021","130080","150569","5.148","23.228","18947","12.399","14107","9.231","155234","9500","9659","53538","150477","339800","490277","16.761","5.144","227596","339708","112112","11.614","3.833"
"Missouri","1980","2916539","128814","-205931","-7.061","23.613","17522","11.333","16453","10.641","155149","11270","11416","61605","132558","211785","344343","11.807","4.545","427288","550274","122986","18.867","4.217"
"Missouri","1981","2762459","128292","-103583","-3.75","24.86","16783","10.86","15520","10.043","155170","9910","10147","52099","143183","200197","343380","12.43","5.183","324301","446963","122662","16.18","4.44"
"Missouri","1982","2675442","126117","-68662","-2.566","29.118","17524","11.405","17791","11.578","153522","11708","12019","59237","159172","230344","389516","14.559","5.949","322024","458178","136154","17.125","5.089"
"Missouri","1983","2597167","129949","-12453","-0.479","29.339","19525","12.635","13344","8.635","157626","8685","8904","48791","149549","231436","380985","14.669","5.758","291400","393438","102038","15.149","3.929"
"Missouri","1984","2702194","135167","262693","9.721","20.365","20903","13.108","13422","8.416","163214","9398","9568","45954","178373","359476","537849","19.904","6.601","175298","275156","99858","10.183","3.695"
"Missouri","1985","2891100","138071","151884","5.254","27.577","20907","12.775","15576","9.518","166321","11218","11451","71130","214771","335755","550526","19.042","7.429","240832","398642","157810","13.789","5.458"
"Missouri","1986","3057432","140190","195063","6.38","23.69","21243","12.741","15523","9.31","169592","11143","11323","66191","196520","360700","557220","18.225","6.428","246154","362157","116003","11.845","3.794"
"Missouri","1987","3155499","142592","-15773","-0.5","33.659","22407","13.147","16635","9.76","173318","11463","11637","75428","193904","337144","531048","16.829","6.145","385628","546821","161193","17.329","5.108"
"Missouri","1988","3183528","147136","40774","1.281","30.2","22797","12.927","16359","9.277","179566","11168","11456","80031","201557","319927","521484","16.381","6.331","326161","480710","154549","15.1","4.855"
"Missouri","1989","3264419","151071","143274","4.389","24.828","23025","12.683","15939","8.78","185087","11394","11785","71727","177903","370612","548515","16.803","5.45","272901","405241","132340","12.414","4.054"
"Missouri","1990","3372069","153941","63930","1.896","27.314","21904","11.756","16447","8.827","189047","11976","12361","76756","198020","326434","524454","15.553","5.872","328719","460524","131805","13.657","3.909"
"Missouri","1991","3314070","153842","-131239","-3.96","26.352","21413","11.329","17917","9.48","190755","12764","13129","98501","170757","265910","436667","13.176","5.152","400946","567906","166960","17.136","5.038"
"Missouri","1992","3264291","153738","46145","1.414","27.544","19811","10.424","17929","9.434","190997","11856","12167","71322","152480","343217","495697","15.185","4.671","316827","449552","132725","13.772","4.066"
"Missouri","1993","3335229","156621","91104","2.732","26.548","20337","10.587","17156","8.931","193684","11380","11739","67117","170620","363200","533820","16.006","5.116","296794","442716","145922","13.274","4.375"
"Missouri","1994","3450463","159734","110374","3.199","24.805","21176","10.823","17172","8.776","197668","11925","12349","80293","182059","356257","538316","15.601","5.276","277077","427942","150865","12.402","4.372"
"Missouri","1995","3583151","163720","164777","4.599","23.811","22517","11.265","17064","8.537","202615","11812","12118","78361","205651","385716","591367","16.504","5.739","282983","426590","143607","11.905","4.008"
"Missouri","1996","3642628","165558","31471","0.864","26.878","21985","10.808","17614","8.659","205607","12451","12799","83502","179969","341026","520995","14.303","4.941","342868","489524","146656","13.439","4.026"
"Missouri","1997","3724927","167088","93414","2.508","29.25","22434","10.888","20577","9.987","206964","13351","13844","91798","210318","427873","638191","17.133","5.646","346922","544777","197855","14.625","5.312"
"Missouri","1998","3848214","168556","85559","2.223","26.496","21287","10.224","19096","9.172","209302","12513","13053","81647","201538","393828","595366","15.471","5.237","343185","509807","166622","13.248","4.33"
"Missouri","1999","3927222","168467","69618","1.773","27.074","20455","9.765","18927","9.035","210240","12558","12911","84010","212723","388527","601250","15.31","5.417","358643","531632","172989","13.537","4.405"
"Missouri","2000","4001688","168568","49191","1.229","28.49","20503","9.755","19562","9.307","210656","12267","12642","87629","206849","412380","619229","15.474","5.169","357182","570038","212856","14.245","5.319"
"Missouri","2001","4001270","167470","-63668","-1.591","28.706","20722","9.858","20185","9.602","210481","12596","13035","89022","199889","374421","574310","14.353","4.996","434651","637978","203327","15.944","5.082"
"Missouri","2002","3921422","165797","-117880","-3.006","32.015","22797","10.86","23244","11.072","209703","13921","14322","115414","265581","362145","627726","16.008","6.773","491343","745606","254263","19.014","6.484"
"Missouri","2003","3853774","165856","-19525","-0.507","29.742","21139","10.085","20377","9.722","209984","12518","12915","88029","193027","380075","573102","14.871","5.009","410645","592627","181982","15.378","4.722"
"Missouri","2004","3847689","166434","12297","0.32","27.502","20576","9.805","20095","9.576","210092","12240","12849","92075","189748","351638","541386","14.07","4.931","344708","529089","184381","13.751","4.792"
"Missouri","2005","3812713","167012","-89330","-2.343","26.333","21414","10.178","20187","9.595","211001","12936","13211","84328","186729","315281","502010","13.167","4.898","428860","591340","162480","15.51","4.262"
"Missouri","2006","3761257","167325","18714","0.498","27.394","23652","11.175","21329","10.078","212804","15096","15330","89241","192801","341087","533888","14.194","5.126","350608","515174","164566","13.697","4.375"
"Missouri","2007","3715022","164701","-102387","-2.756","26.042","20829","9.853","22139","10.472","210751","14209","14566","93609","164586","319145","483731","13.021","4.43","402190","586118","183928","15.777","4.951"
"Missouri","2008","3630742","160764","-50830","-1.4","27.131","18741","8.987","22303","10.695","206749","14603","14887","101403","162177","330348","492525","13.565","4.467","361828","543355","181527","14.965","5.0"
"Missouri","2009","3491017","155307","-246826","-7.07","22.929","16370","8.042","23298","11.446","200080","14270","14531","90686","145993","254228","400221","11.464","4.182","474649","647047","172398","18.535","4.938"
"Missouri","2010","3323688","151617","-87939","-2.646","23.494","15969","8.078","19579","9.904","195888","12133","12432","74022","120258","270170","390428","11.747","3.618","333860","478367","144507","14.393","4.348"
"Missouri","2011","3327102","150837","100448","3.019","22.406","17789","9.091","17326","8.854","195917","10889","11184","61393","127132","346044","473176","14.222","3.821","251571","372728","121157","11.203","3.642"
"Missouri","2012","3415619","151545","85566","2.505","22.545","17012","8.698","16586","8.48","195809","9752","10063","71507","118657","351931","470588","13.778","3.474","250557","385022","134465","11.272","3.937"
"Missouri","2013","3477845","151304","73309","2.108","20.803","16348","8.364","16073","8.223","195590","10019","10136","58676","125153","309910","435063","12.51","3.599","253257","361754","108497","10.402","3.12"
"Missouri","2014","3549384","151302","85936","2.421","20.044","16474","8.419","15352","7.845","196245","9897","10120","60422","124677","316973","441650","12.443","3.513","244482","355714","111232","10.022","3.134"
"Missouri","2015","3658513","151994","116337","3.18","19.658","17829","9.05","15445","7.84","198188","9957","10225","59188","145448","330479","475927","13.009","3.976","255621","359590","103969","9.829","2.842"
"Missouri","2016","3758132","153498","82554","2.197","19.944","17554","8.803","14476","7.26","200940","10030","10314","69418","135451","321863","457314","12.169","3.604","265045","374760","109715","9.972","2.919"
"Missouri","2017","3818570","153208","55741","1.46","21.708","15992","7.975","16063","8.011","200482","10457","10820","67608","121889","348325","470214","12.314","3.192","282175","414473","132298","10.854","3.465"
"Missouri","2018","3889859","153488","103957","2.673","19.86","15757","7.864","15065","7.519","200711","10999","11403","70653","133205","357011","490216","12.602","3.424","267969","386259","118290","9.93","3.041"
"Montana","1978","1278433","67813","137531","10.758","24.791","11287","14.47","7886","10.11","79705","5307","5387","27901","92058","203939","295997","23.153","7.201","89736","158466","68730","12.395","5.376"
"Montana","1979","1396590","70093","89475","6.407","26.147","10514","13.03","7385","9.152","82256","4914","4964","27720","90239","181822","272061","19.48","6.461","115135","182586","67451","13.074","4.83"
"Montana","1980","1448013","70123","20561","1.42","29.072","9537","11.597","8274","10.061","82868","5586","5675","33595","84261","146785","231046","15.956","5.819","143777","210485","66708","14.536","4.607"
"Montana","1981","1450692","70899","-2487","-0.171","29.037","9255","11.135","7334","8.824","84079","4891","5010","29446","80275","130345","210620","14.519","5.534","156007","213107","57100","14.69","3.936"
"Montana","1982","1442278","70610","-9036","-0.627","29.888","9747","11.644","8685","10.375","84239","5884","5984","30675","87558","127973","215531","14.944","6.071","162080","224567","62487","15.57","4.333"
"Montana","1983","1421321","72505","-5770","-0.406","31.101","9928","11.738","6782","8.019","86152","4485","4563","25340","94672","126348","221020","15.55","6.661","167654","226790","59136","15.956","4.161"
"Montana","1984","1462760","75689","106058","7.251","22.73","11699","13.408","7006","8.03","89598","4906","5021","28594","90321","181982","272303","18.616","6.175","112491","166245","53754","11.365","3.675"
"Montana","1985","1538832","76332","81786","5.315","26.513","11327","12.702","8776","9.841","90449","6334","6455","45984","101103","184680","285783","18.571","6.57","126321","203997","77676","13.257","5.048"
"Montana","1986","1576008","76521","30743","1.951","29.644","11168","12.425","8891","9.892","91020","6220","6361","41435","100888","163451","264339","16.773","6.401","162169","233596","71427","14.822","4.532"
"Montana","1987","1611017","77479","61701","3.83","28.729","11802","12.954","8848","9.712","92583","5972","6078","40748","110543","182575","293118","18.195","6.862","149120","231417","82297","14.365","5.108"
"Montana","1988","1681647","79662","59137","3.517","27.884","11995","12.747","8583","9.121","95810","5966","6088","43489","113401","180191","293592","17.459","6.743","154499","234455","79956","13.942","4.755"
"Montana","1989","1737678","81171","84538","4.865","25.077","11814","12.252","8535","8.851","98066","5943","6106","41849","109390","193024","302414","17.403","6.295","134814","217876","83062","12.538","4.78"
"Montana","1990","1799897","82928","57383","3.188","24.622","11423","11.593","8284","8.407","100102","5936","6075","40910","92243","186725","278968","15.499","5.125","146093","221585","75492","12.311","4.194"
"Montana","1991","1822217","83550","-26945","-1.479","29.24","12120","12.058","8947","8.902","102097","6289","6487","54013","104751","161654","266405","14.62","5.749","205802","293350","87548","16.099","4.804"
"Montana","1992","1824938","84332","47889","2.624","26.164","11327","11.101","9091","8.91","103154","5880","6053","40329","95011","191613","286624","15.706","5.206","161768","238735","76967","13.082","4.218"
"Montana","1993","1873512","86887","60049","3.205","24.301","11514","11.037","8674","8.315","105741","5609","5833","36486","93569","194119","287688","15.356","4.994","152869","227639","74770","12.15","3.991"
"Montana","1994","1943498","89338","51447","2.647","24.224","12056","11.227","8884","8.273","108969","6051","6214","48492","94155","192691","286846","14.759","4.845","150536","235399","84863","12.112","4.367"
"Montana","1995","2006552","91425","82438","4.108","21.727","11935","10.84","9163","8.322","111489","6216","6409","40139","104778","195637","300415","14.972","5.222","148550","217977","69427","10.863","3.46"
"Montana","1996","2052325","92944","48409","2.359","23.639","12048","10.751","9434","8.419","113367","6481","6650","44403","98826","192155","290981","14.178","4.815","166384","242572","76188","11.819","3.712"
"Montana","1997","2115353","94694","66257","3.132","25.983","12955","11.326","10513","9.191","115602","6737","6969","46826","114061","227008","341069","16.124","5.392","179225","274812","95587","12.991","4.519"
"Montana","1998","2212856","97090","77587","3.506","24.782","12218","10.441","9719","8.305","118270","6299","6449","41862","110910","240872","351782","15.897","5.012","188221","274195","85974","12.391","3.885"
"Montana","1999","2275186","98268","50418","2.216","25.156","12366","10.384","10123","8.501","120204","6528","6749","44467","116883","219703","336586","14.794","5.137","186184","286168","99984","12.578","4.395"
"Montana","2000","2337770","99282","64136","2.743","24.44","11996","9.931","10294","8.522","121648","6671","6881","43747","110653","239154","349807","14.963","4.733","196313","285671","89358","12.22","3.822"
"Montana","2001","2371169","99963","11507","0.485","27.235","13045","10.652","10681","8.722","123643","6775","6964","45932","126800","207605","334405","14.103","5.348","219610","322898","103288","13.618","4.356"
"Montana","2002","2371311","99855","-48253","-2.035","30.038","13882","11.199","13107","10.573","124349","7700","7943","63152","131747","224403","356150","15.019","5.556","272803","404403","131600","17.054","5.55"
"Montana","2003","2351780","101380","18006","0.766","28.12","13809","11.035","11709","9.357","126188","6942","7045","40471","125090","223575","348665","14.826","5.319","226285","330659","104374","14.06","4.438"
"Montana","2004","2367252","103147","11669","0.493","25.201","13677","10.756","11382","8.951","128302","7035","7205","42926","95728","214226","309954","13.093","4.044","197806","298285","100479","12.6","4.245"
"Montana","2005","2394789","104785","38723","1.617","23.506","13792","10.666","11555","8.936","130424","7354","7455","41559","111533","208652","320185","13.37","4.657","198254","281462","83208","11.753","3.475"
"Montana","2006","2440436","106136","55510","2.275","23.97","16108","12.238","12993","9.871","133179","8932","9075","52602","122993","225008","348001","14.26","5.04","195838","292491","96653","11.985","3.96"
"Montana","2007","2488853","105915","41238","1.657","26.172","13974","10.507","13484","10.138","133248","8104","8198","44628","114146","252786","366932","14.743","4.586","223632","325694","102062","13.086","4.101"
"Montana","2008","2495555","104066","-29933","-1.199","25.003","12263","9.272","13671","10.336","131560","8699","8909","49581","100153","211832","311985","12.502","4.013","242196","341918","99722","13.701","3.996"
"Montana","2009","2431603","101546","-110919","-4.562","22.092","11020","8.447","13640","10.455","129153","8379","8564","46925","92137","176462","268599","11.046","3.789","293291","379518","86227","15.608","3.546"
"Montana","2010","2362057","100384","-23131","-0.979","22.245","11009","8.566","11783","9.169","128127","7041","7179","38899","83916","178799","262715","11.122","3.553","202076","285846","83770","12.102","3.546"
"Montana","2011","2368833","99995","43134","1.821","19.441","11490","8.975","11157","8.715","128187","6981","7181","35537","75514","197882","273396","11.541","3.188","164746","230262","65516","9.72","2.766"
"Montana","2012","2422143","100429","71132","2.937","19.742","11243","8.771","10592","8.263","128514","6218","6414","40770","75460","234761","310221","12.808","3.115","164163","239089","74926","9.871","3.093"
"Montana","2013","2486179","100465","39117","1.573","21.088","11164","8.681","10355","8.052","129007","6263","6321","34087","78888","222366","301254","12.117","3.173","193286","262137","68851","10.544","2.769"
"Montana","2014","2529897","101035","53082","2.098","18.3","11496","8.864","9723","7.497","130578","6210","6347","38957","79732","204836","284568","11.248","3.152","167326","231486","64160","9.15","2.536"
"Montana","2015","2554146","101621","48526","1.9","19.626","11651","8.886","10072","7.682","131909","6352","6546","34565","89621","209540","299161","11.713","3.509","182632","250635","68003","9.813","2.662"
"Montana","2016","2600982","102505","52283","2.01","20.256","12017","9.045","9632","7.25","134051","6625","6761","43747","96602","219112","315714","12.138","3.714","183662","263431","79769","10.128","3.067"
"Montana","2017","2637170","102803","33933","1.287","22.332","11415","8.511","10764","8.026","134446","6951","7125","42165","105227","223168","328395","12.453","3.99","202251","294462","92211","11.166","3.497"
"Montana","2018","2688172","102324","81833","3.044","19.428","10304","7.694","10700","7.989","133731","7588","7863","51392","112603","230358","342961","12.758","4.189","178087","261128","83041","9.714","3.089"
"Nebraska","1978","573101","35798","46611","8.133","28.002","6525","15.871","5172","12.58","41788","3517","3541","17316","46930","79922","126852","22.134","8.189","44927","80241","35314","14.001","6.162"
"Nebraska","1979","605465","36782","19004","3.139","30.84","6278","14.842","4728","11.178","43074","3233","3264","17661","42993","69374","112367","18.559","7.101","56954","93363","36409","15.42","6.013"
"Nebraska","1980","612747","36948","-5441","-0.888","32.477","5733","13.287","4989","11.563","43520","3656","3685","17418","42069","57433","99502","16.239","6.866","74041","104943","30902","17.127","5.043"
"Nebraska","1981","611198","36773","-1877","-0.307","30.153","5169","11.914","4772","10.999","43583","3369","3422","15283","36093","56054","92147","15.076","5.905","65689","94024","28335","15.384","4.636"
"Nebraska","1982","604148","35676","-8758","-1.45","30.446","5154","12.017","5594","13.043","42669","3865","3894","17644","39580","52388","91968","15.223","6.551","67390","100726","33336","16.672","5.518"
"Nebraska","1983","583020","36285","-7132","-1.223","31.164","5610","13.22","4417","10.409","43031","2928","2979","14393","33905","56941","90846","15.582","5.815","64218","97978","33760","16.805","5.791"
"Nebraska","1984","609119","38330","64058","10.517","23.793","6907","15.713","3975","9.043","45424","2962","3007","13994","62873","73650","136523","22.413","10.322","47927","72465","24538","11.897","4.028"
"Nebraska","1985","640093","38357","9941","1.553","31.741","6114","13.537","5104","11.301","45670","3675","3731","19773","44121","67407","111528","17.424","6.893","67481","101587","34106","15.871","5.328"
"Nebraska","1986","655511","38593","26488","4.041","30.234","5888","12.956","4765","10.485","46008","3331","3383","17445","46410","79172","125582","19.158","7.08","66489","99094","32605","15.117","4.974"
"Nebraska","1987","671276","38630","531","0.079","34.66","6115","13.384","5178","11.333","46159","3537","3588","21591","46954","69910","116864","17.409","6.995","76544","116333","39789","17.33","5.927"
"Nebraska","1988","687097","39147","26408","3.843","28.517","6201","13.304","5007","10.742","47207","3521","3575","20845","53571","70808","124379","18.102","7.797","61692","97971","36279","14.259","5.28"
"Nebraska","1989","707595","39518","19527","2.76","28.112","6140","12.997","4831","10.226","47897","3482","3548","20453","45749","73236","118985","16.815","6.465","63654","99458","35804","14.056","5.06"
"Nebraska","1990","725017","39987","22140","3.054","26.13","6020","12.558","4865","10.149","48515","3603","3686","21202","43130","73733","116863","16.119","5.949","62536","94723","32187","13.065","4.439"
"Nebraska","1991","737607","39813","6019","0.816","29.84","5985","12.372","5036","10.41","48849","3572","3626","21292","46423","69648","116071","15.736","6.294","75293","110052","34759","14.92","4.712"
"Nebraska","1992","742163","40047","16703","2.251","27.031","5470","11.245","4653","9.565","49054","3146","3213","17872","35173","81837","117010","15.766","4.739","69058","100307","31249","13.515","4.211"
"Nebraska","1993","765704","41058","35031","4.575","26.016","5871","11.856","4637","9.364","50137","3270","3310","23485","49306","85326","134632","17.583","6.439","60782","99601","38819","13.008","5.07"
"Nebraska","1994","807055","41717","43611","5.404","25.01","6027","11.92","5091","10.069","51031","3701","3784","19885","55973","88559","144532","17.909","6.935","65747","100921","35174","12.505","4.358"
"Nebraska","1995","842257","42545","31823","3.778","26.226","6165","11.97","4848","9.413","52164","3502","3608","21721","54869","87400","142269","16.891","6.515","71723","110446","38723","13.113","4.598"
"Nebraska","1996","851363","42948","5366","0.63","29.268","6136","11.719","5075","9.693","52888","3699","3765","24726","53271","76685","129956","15.264","6.257","82065","124590","42525","14.634","4.995"
"Nebraska","1997","872670","43289","26876","3.08","28.012","6253","11.772","5385","10.138","53550","3721","3774","20958","51137","97966","149103","17.086","5.86","83766","122227","38461","14.006","4.407"
"Nebraska","1998","925597","43738","27255","2.945","24.967","5997","11.128","5234","9.712","54273","3607","3693","21809","48936","93868","142804","15.428","5.287","73764","115549","41785","12.484","4.514"
"Nebraska","1999","940663","43774","9666","1.028","27.985","6010","11.062","5437","10.008","54615","3806","3884","24046","49492","91798","141290","15.02","5.261","82915","131624","48709","13.993","5.178"
"Nebraska","2000","951644","43256","14153","1.487","26.007","5590","10.279","5457","10.035","54448","3641","3738","21904","51794","86104","137898","14.491","5.443","80039","123745","43706","13.003","4.593"
"Nebraska","2001","943202","42681","-33680","-3.571","26.393","5605","10.363","5678","10.498","54051","3619","3778","27886","48025","76444","124469","13.196","5.092","101810","158149","56339","16.767","5.973"
"Nebraska","2002","921600","42922","-17078","-1.853","30.86","6197","11.423","5540","10.212","54578","3450","3527","27808","56962","85239","142201","15.43","6.181","102679","159279","56600","17.283","6.141"
"Nebraska","2003","914252","43228","4964","0.543","29.533","5755","10.53","5120","9.368","54973","3318","3365","20592","49214","90753","139967","15.309","5.383","91256","135003","43747","14.767","4.785"
"Nebraska","2004","923811","43536","14706","1.592","25.701","5527","10.029","4849","8.799","55449","3238","3296","18591","44619","88802","133421","14.442","4.83","78978","118715","39737","12.851","4.301"
"Nebraska","2005","927706","43646","-3520","-0.379","27.062","5807","10.457","5269","9.488","55801","3416","3490","21976","43612","81918","125530","13.531","4.701","86659","129050","42391","13.911","4.569"
"Nebraska","2006","935999","43362","17772","1.899","28.025","6644","11.926","6179","11.091","55942","4135","4208","22902","57565","91364","148929","15.911","6.15","88648","131157","42509","14.013","4.542"
"Nebraska","2007","940899","44096","-5053","-0.537","27.854","6428","11.409","4960","8.804","57075","3262","3330","18460","41721","89319","131040","13.927","4.434","97001","136093","39092","14.464","4.155"
"Nebraska","2008","938818","43613","5793","0.617","26.717","5280","9.289","5236","9.211","56864","3596","3686","19687","41551","89653","131204","13.975","4.426","85230","125411","40181","13.358","4.28"
"Nebraska","2009","923568","42661","-44546","-4.823","22.61","4638","8.217","5508","9.758","56011","3703","3829","26469","43062","61348","104410","11.305","4.663","105591","148956","43365","16.128","4.695"
"Nebraska","2010","890758","42118","-19366","-2.174","21.431","4494","8.077","4763","8.561","55503","3111","3198","17276","32117","63330","95447","10.715","3.606","83609","114813","31204","12.889","3.503"
"Nebraska","2011","886531","41725","12878","1.453","21.237","4622","8.355","4518","8.167","55373","2976","3110","16151","32905","74108","107013","12.071","3.712","67167","94135","26968","10.618","3.042"
"Nebraska","2012","896036","41362","3469","0.387","21.793","4345","7.889","4409","8.005","55044","2779","2843","14126","29134","71973","101107","11.284","3.251","72110","97638","25528","10.897","2.849"
"Nebraska","2013","894501","41089","4324","0.483","20.703","4228","7.719","4159","7.594","54805","2709","2756","15515","29264","67653","96917","10.835","3.272","66869","92593","25724","10.351","2.876"
"Nebraska","2014","901524","41046","11379","1.262","19.365","4354","7.942","3945","7.196","55028","2655","2709","13764","30637","68031","98668","10.945","3.398","62876","87289","24413","9.682","2.708"
"Nebraska","2015","915648","40874","18836","2.057","20.607","4256","7.748","4082","7.431","55017","2742","2798","15806","42042","71140","113182","12.361","4.592","68338","94346","26008","10.304","2.84"
"Nebraska","2016","931550","40912","14107","1.514","20.372","4420","8.023","3913","7.103","55343","2649","2717","13684","34312","74683","108995","11.7","3.683","68550","94888","26338","10.186","2.827"
"Nebraska","2017","935399","40780","-368","-0.039","22.526","4335","7.853","4196","7.601","55272","2727","2801","14795","30027","75329","105356","11.263","3.21","74287","105724","31437","11.303","3.361"
"Nebraska","2018","939998","40702","4389","0.467","20.479","4084","7.412","3871","7.025","55210","2733","2848","15835","28411","72231","100642","10.707","3.022","69784","96253","26469","10.24","2.816"
"Nevada","1978","1505275","81196","129213","8.584","26.345","14136","14.917","11227","11.848","96216","7426","7567","36778","112559","214938","327497","21.757","7.478","117631","198284","80653","13.173","5.358"
"Nevada","1979","1604029","83216","68146","4.248","26.494","13201","13.607","10220","10.535","98505","6742","6831","35645","95266","185362","280628","17.495","5.939","131806","212482","80676","13.247","5.03"
"Nevada","1980","1635500","82588","-17768","-1.086","29.308","11654","11.89","10879","11.1","98400","7730","7861","39068","92162","147501","239663","14.654","5.635","180956","257431","76475","15.74","4.676"
"Nevada","1981","1620831","83003","-1045","-0.064","29.649","11631","11.824","9890","10.054","99241","6537","6662","31482","97827","142453","240280","14.824","6.036","166590","241325","74735","14.889","4.611"
"Nevada","1982","1613105","81146","-6421","-0.398","30.726","11519","11.757","11850","12.095","97811","8062","8225","37919","97854","149966","247820","15.363","6.066","173505","254241","80736","15.761","5.005"
"Nevada","1983","1592554","83968","1590","0.1","31.251","13056","13.259","8884","9.022","100555","5805","5931","33481","92103","158329","250432","15.725","5.783","177421","248842","71421","15.625","4.485"
"Nevada","1984","1633110","86735","106895","6.545","24.271","14271","14.093","9489","9.371","103652","6795","6889","33466","105670","199415","305085","18.681","6.47","136202","198190","61988","12.136","3.796"
"Nevada","1985","1700557","88157","67783","3.986","27.831","14045","13.563","10712","10.344","105222","7709","7843","47814","113020","191408","304428","17.902","6.646","139191","236645","97454","13.916","5.731"
"Nevada","1986","1752955","89081","65695","3.748","28.834","14423","13.727","10515","10.007","107026","7477","7664","47374","125752","192667","318419","18.165","7.174","162320","252724","90404","14.417","5.157"
"Nevada","1987","1809675","90827","64594","3.569","31.719","15228","14.158","11240","10.45","109555","7645","7799","48105","143677","207922","351599","19.429","7.939","194085","287005","92920","15.859","5.135"
"Nevada","1988","1847673","93213","40105","2.171","30.23","14981","13.474","11133","10.013","113105","7806","7938","47010","121137","198247","319384","17.286","6.556","183041","279279","96238","15.115","5.209"
"Nevada","1989","1897711","95221","77803","4.1","27.18","14884","13.068","10932","9.598","115869","7808","8034","50862","111416","224287","335703","17.69","5.871","170029","257900","87871","13.59","4.63"
"Nevada","1990","1956049","96836","52801","2.699","26.039","14154","12.178","11077","9.531","117763","7906","8140","48342","110813","196653","307466","15.719","5.665","175582","254665","79083","13.019","4.043"
"Nevada","1991","1960233","96174","-16626","-0.848","28.935","14186","12.091","11910","10.151","118466","8466","8716","60699","114328","169268","283596","14.467","5.832","201611","300222","98611","15.316","5.031"
"Nevada","1992","1980894","96780","32313","1.631","27.015","13408","11.353","11448","9.693","119080","7506","7661","40025","103016","196866","299882","15.139","5.2","186590","267569","80979","13.507","4.088"
"Nevada","1993","1996920","98813","23393","1.171","27.474","13699","11.433","11402","9.516","120968","7604","7786","47290","98896","198812","297708","14.908","4.952","179729","274315","94586","13.737","4.737"
"Nevada","1994","2045683","100915","58661","2.868","26.205","14796","12.101","11947","9.771","123694","8367","8588","56017","112988","213706","326694","15.97","5.523","170896","268033","97137","13.102","4.748"
"Nevada","1995","2106626","102868","70361","3.34","25.813","14825","11.884","11923","9.558","126199","8403","8628","51934","113718","228537","342255","16.247","5.398","175132","271894","96762","12.907","4.593"
"Nevada","1996","2128379","103546","30788","1.447","27.413","14240","11.268","11999","9.495","127497","8626","8783","49380","114230","208289","322519","15.153","5.367","195592","291731","96139","13.707","4.517"
"Nevada","1997","2181771","103481","63587","2.914","27.612","14263","11.194","13690","10.745","127700","9317","9611","54913","118344","246454","364798","16.72","5.424","196228","301211","104983","13.806","4.812"
"Nevada","1998","2265453","104512","36576","1.615","26.245","13936","10.842","12309","9.576","129350","8185","8387","46962","119231","214631","333862","14.737","5.263","205592","297286","91694","13.123","4.047"
"Nevada","1999","2312378","104680","46161","1.996","26.318","13653","10.537","12442","9.602","130183","8371","8577","48877","118314","232135","350449","15.155","5.117","196942","304288","107346","13.159","4.642"
"Nevada","2000","2356090","104735","37225","1.58","27.149","13544","10.397","12646","9.708","130719","8380","8596","48797","118503","238550","357053","15.154","5.03","209450","319828","110378","13.575","4.685"
"Nevada","2001","2375200","103560","5934","0.25","27.667","12772","9.804","12692","9.743","130311","8377","8577","51564","117397","217113","334510","14.083","4.943","219675","328576","108901","13.834","4.585"
"Nevada","2002","2368432","104293","-58810","-2.483","31.2","15637","11.938","14087","10.755","131759","8609","8860","74237","148387","221085","369472","15.6","6.265","281685","428282","146597","18.083","6.19"
"Nevada","2003","2354145","105897","34939","1.484","26.205","15159","11.444","12935","9.765","133580","8324","8548","47782","102702","240687","343389","14.587","4.363","207329","308450","101121","13.102","4.295"
"Nevada","2004","2381280","108208","36705","1.541","25.739","15748","11.685","12816","9.509","136242","8513","8638","48228","119568","223599","343167","14.411","5.021","203974","306462","102488","12.87","4.304"
"Nevada","2005","2395823","110344","-6081","-0.254","25.744","16321","11.863","13209","9.601","139133","9104","9269","50257","113091","195301","308392","12.872","4.72","227197","314473","87276","13.126","3.643"
"Nevada","2006","2416441","109772","53178","2.201","25.485","17310","12.424","15762","11.313","140096","11574","11782","57489","137029","224065","361094","14.943","5.671","203304","307916","104612","12.743","4.329"
"Nevada","2007","2437417","109214","-8211","-0.337","27.435","15185","10.844","14207","10.145","140524","9401","9599","49806","113287","221060","334347","13.717","4.648","237509","342558","105049","14.054","4.31"
"Nevada","2008","2436210","107558","13983","0.574","26.057","13363","9.566","14252","10.202","139250","9473","9606","45880","112266","219117","331383","13.602","4.608","218494","317400","98906","13.028","4.06"
"Nevada","2009","2386696","105289","-109023","-4.568","21.701","12364","8.949","14870","10.762","136912","9768","9966","57139","88798","170175","258973","10.851","3.721","259027","367996","108969","15.419","4.566"
"Nevada","2010","2302617","103684","-59005","-2.563","22.156","12992","9.579","13520","9.968","135366","8460","8699","42034","90977","164110","255087","11.078","3.951","229726","314092","84366","13.641","3.664"
"Nevada","2011","2274248","101423","3780","0.166","21.817","12249","9.134","13022","9.711","133713","8718","8913","39256","75843","176027","251870","11.075","3.335","176824","248090","71266","10.909","3.134"
"Nevada","2012","2292434","101306","33711","1.471","22.067","12579","9.432","12462","9.344","133425","7843","8208","37253","83302","203349","286651","12.504","3.634","175593","252940","77347","11.034","3.374"
"Nevada","2013","2329190","103259","36262","1.557","20.78","13787","10.243","11729","8.714","135624","7381","7543","35704","86888","191381","278269","11.947","3.73","166198","242007","75809","10.39","3.255"
"Nevada","2014","2369586","105570","47214","1.993","19.585","14911","10.876","11741","8.564","138680","7862","7972","36757","83894","195361","279255","11.785","3.54","162300","232041","69741","9.792","2.943"
"Nevada","2015","2413112","107697","44080","1.827","21.878","15373","10.992","12395","8.862","141348","8116","8325","41339","106653","201400","308053","12.766","4.42","177638","263973","86335","10.939","3.578"
"Nevada","2016","2462371","110006","57257","2.325","19.67","15718","10.986","11859","8.289","144998","8365","8492","40570","97506","201922","299428","12.16","3.96","169355","242171","72816","9.835","2.957"
"Nevada","2017","2498907","110070","37307","1.493","22.742","14407","9.967","14028","9.704","144743","9290","9499","46147","100105","221353","321458","12.864","4.006","186678","284151","97473","11.371","3.901"
"Nevada","2018","2519807","103895","20109","0.798","22.061","12812","9.303","11461","8.322","138389","8318","8564","45557","91850","206200","298050","11.828","3.645","196156","277941","81785","11.03","3.246"
"New Hampshire","1978","186095","17064","22827","12.266","31.067","3255","17.063","2488","13.042","19460","1730","1737","7646","17693","34041","51734","27.8","9.508","14554","28907","14353","15.533","7.713"
"New Hampshire","1979","204820","17890","13630","6.655","30.602","3276","16.51","2249","11.334","20356","1595","1606","7739","17577","27392","44969","21.955","8.582","19325","31339","12014","15.301","5.866"
"New Hampshire","1980","208946","17784","-5880","-2.814","35.484","2715","13.441","2707","13.402","20203","1826","1836","8914","15597","21474","37071","17.742","7.465","28035","42951","14916","20.556","7.139"
"New Hampshire","1981","205307","17901","-196","-0.095","35.865","2646","13.11","2275","11.272","20369","1537","1555","6432","13626","23191","36817","17.933","6.637","24756","37013","12257","18.028","5.97"
"New Hampshire","1982","203220","17709","-2003","-0.986","37.319","2860","14.161","2657","13.156","20298","1794","1808","8031","16342","21578","37920","18.66","8.042","27599","39923","12324","19.645","6.064"
"New Hampshire","1983","201380","18358","1843","0.915","37.362","2939","14.353","1945","9.499","20973","1327","1353","7504","18227","21236","39463","19.596","9.051","26293","37620","11327","18.681","5.625"
"New Hampshire","1984","205773","19285","8726","4.241","31.901","3326","15.596","2081","9.758","21949","1476","1494","6575","18179","23369","41548","20.191","8.834","22822","32822","10000","15.951","4.86"
"New Hampshire","1985","206844","19221","-999","-0.483","34.475","2878","13.268","2625","12.102","21818","1901","1912","8573","13332","22323","35655","17.238","6.445","22730","36654","13924","17.721","6.732"
"New Hampshire","1986","202965","18901","-2541","-1.252","33.337","2795","13.003","2610","12.143","21587","1894","1911","8733","14383","19448","33831","16.668","7.086","23936","36372","12436","17.92","6.127"
"New Hampshire","1987","202181","18877","4210","2.082","36.327","2974","13.888","2597","12.128","21602","1836","1863","8302","17131","23802","40933","20.246","8.473","22550","36723","14173","18.163","7.01"
"New Hampshire","1988","205829","19095","286","0.139","36.706","2814","12.943","2443","11.237","21927","1711","1726","8578","14926","23136","38062","18.492","7.252","22876","37776","14900","18.353","7.239"
"New Hampshire","1989","209748","19134","10501","5.006","27.524","2652","12.154","2245","10.288","22024","1627","1642","7191","14725","24641","39366","18.768","7.02","18466","28865","10399","13.762","4.958"
"New Hampshire","1990","219053","19532","8747","3.993","26.923","2603","11.766","1982","8.959","22433","1414","1430","5865","12110","26125","38235","17.455","5.528","18347","29488","11141","13.462","5.086"
"New Hampshire","1991","223624","19652","3610","1.614","30.05","2711","12.058","2066","9.189","22805","1488","1518","7423","14677","22533","37210","16.64","6.563","23096","33600","10504","15.025","4.697"
"New Hampshire","1992","230179","20094","13235","5.75","27.376","2943","12.817","2069","9.011","23398","1375","1404","6537","14589","30153","44742","19.438","6.338","19409","31507","12098","13.688","5.256"
"New Hampshire","1993","239727","20512","6524","2.721","28.721","2724","11.556","2226","9.443","23822","1513","1539","7236","12878","28072","40950","17.082","5.372","23229","34426","11197","14.361","4.671"
"New Hampshire","1994","246340","21240","6054","2.458","28.118","3001","12.389","2196","9.066","24626","1560","1582","7418","15310","25377","40687","16.517","6.215","23072","34633","11561","14.059","4.693"
"New Hampshire","1995","254075","21937","12029","4.734","24.321","3184","12.747","2267","9.076","25436","1617","1640","7411","16489","26437","42926","16.895","6.49","19991","30897","10906","12.161","4.292"
"New Hampshire","1996","260559","22440","5220","2.003","27.957","3131","12.245","2539","9.93","25866","1689","1715","8344","16018","25624","41642","15.982","6.148","22949","36422","13473","13.978","5.171"
"New Hampshire","1997","266469","22948","5707","2.142","31.403","3221","12.346","2626","10.066","26386","1763","1787","8297","16980","30567","47547","17.843","6.372","26809","41840","15031","15.702","5.641"
"New Hampshire","1998","275939","23491","4878","1.768","29.933","3318","12.42","2690","10.069","27029","1859","1899","8276","17862","28315","46177","16.735","6.473","25093","41299","16206","14.967","5.873"
"New Hampshire","1999","282119","23669","10685","3.787","26.244","3010","11.1","2650","9.772","27298","1814","1857","8428","16166","31538","47704","16.909","5.73","23178","37019","13841","13.122","4.906"
"New Hampshire","2000","293060","23908","10859","3.705","25.778","3115","11.347","2634","9.595","27692","1793","1829","8207","15884","32747","48631","16.594","5.42","24377","37772","13395","12.889","4.571"
"New Hampshire","2001","302300","24187","8092","2.677","26.977","3126","11.225","2579","9.261","28122","1691","1716","7998","17858","31010","48868","16.165","5.907","28263","40776","12513","13.489","4.139"
"New Hampshire","2002","302464","24275","-4432","-1.465","33.069","3255","11.533","2980","10.559","28360","1807","1833","10225","19105","30906","50011","16.535","6.316","35917","54443","18526","18.0","6.125"
"New Hampshire","2003","302238","24887","4454","1.474","28.266","3355","11.716","2633","9.195","28996","1661","1677","7433","16706","30463","47169","15.607","5.527","29151","42715","13564","14.133","4.488"
"New Hampshire","2004","309538","25706","10945","3.536","24.367","3632","12.37","2717","9.253","29820","1718","1749","8267","16069","32589","48658","15.72","5.191","22563","37713","15150","12.184","4.894"
"New Hampshire","2005","321665","26479","11874","3.691","25.144","3668","12.135","2703","8.943","30708","1790","1816","7321","21480","30834","52314","16.264","6.678","28815","40440","11625","12.572","3.614"
"New Hampshire","2006","332787","27515","10000","3.005","28.059","4631","14.801","3221","10.295","31993","2318","2343","10243","22870","33818","56688","17.034","6.872","31437","46688","15251","14.029","4.583"
"New Hampshire","2007","347729","28265","12426","3.573","26.233","4051","12.51","2981","9.206","32917","1972","1995","8403","19816","38219","58035","16.69","5.699","31564","45609","14045","13.116","4.039"
"New Hampshire","2008","355755","28116","4564","1.283","26.285","3368","10.264","3353","10.218","32821","2289","2320","9307","15626","35693","51319","14.425","4.392","31437","46755","15318","13.142","4.306"
"New Hampshire","2009","348922","27138","-18394","-5.272","22.163","2828","8.755","3828","11.851","31801","2425","2465","9344","12149","26516","38665","11.081","3.482","42329","57059","14730","16.353","4.222"
"New Hampshire","2010","338149","26777","-2843","-0.841","25.505","2938","9.3","3190","10.098","31465","2011","2038","9112","16312","26811","43123","12.753","4.824","31837","45966","14129","13.593","4.178"
"New Hampshire","2011","335629","26454","-1399","-0.417","24.382","3017","9.649","3171","10.141","31191","1958","2007","7937","12431","28486","40917","12.191","3.704","29016","42316","13300","12.608","3.963"
"New Hampshire","2012","338255","26753","7016","2.074","22.456","3243","10.358","2769","8.844","31547","1658","1686","6507","13974","31022","44996","13.302","4.131","26328","37980","11652","11.228","3.445"
"New Hampshire","2013","345010","26947","7616","2.207","21.807","3175","10.045","2850","9.017","31769","1807","1834","7627","13852","31383","45235","13.111","4.015","25125","37619","12494","10.904","3.621"
"New Hampshire","2014","354979","27099","13190","3.716","19.904","3123","9.797","2705","8.486","32085","1792","1807","7351","14518","34000","48518","13.668","4.09","24759","35328","10569","9.952","2.977"
"New Hampshire","2015","366323","27479","10033","2.739","20.892","3181","9.854","2648","8.203","32548","1809","1850","7299","15300","32999","48299","13.185","4.177","26306","38266","11960","10.446","3.265"
"New Hampshire","2016","372806","27685","4144","1.112","21.531","3162","9.661","2667","8.148","32978","1899","1906","8090","16005","28273","44278","11.877","4.293","28620","40134","11514","10.765","3.088"
"New Hampshire","2017","375227","27752","2633","0.702","24.285","2931","8.893","2770","8.405","33039","1878","1916","8735","13354","34841","48195","12.844","3.559","31397","45562","14165","12.143","3.775"
"New Hampshire","2018","372706","28033","-6916","-1.856","23.361","3106","9.37","2762","8.332","33320","2096","2122","8518","14355","29178","43533","11.68","3.852","37562","50449","12887","13.536","3.458"
"New Jersey","1978","441544","31286","26711","6.049","28.335","4738","13.315","3778","10.617","36065","2635","2682","14116","33009","56257","89266","20.217","7.476","36803","62555","25752","14.167","5.832"
"New Jersey","1979","464644","32184","21505","4.628","24.714","4476","12.292","3328","9.139","36989","2268","2288","11525","25469","53452","78921","16.985","5.481","35613","57416","21803","12.357","4.692"
"New Jersey","1980","477481","32055","1894","0.397","29.71","4136","11.209","3807","10.318","37062","2815","2850","12473","28073","44751","72824","15.252","5.879","50329","70930","20601","14.855","4.315"
"New Jersey","1981","480280","32240","5163","1.075","27.909","4008","10.809","3427","9.242","37370","2344","2380","10667","27641","44543","72184","15.03","5.755","46317","67021","20704","13.955","4.311"
"New Jersey","1982","477604","31613","-7844","-1.642","28.426","3986","10.807","4182","11.339","36785","2836","2928","12665","27832","40050","67882","14.213","5.827","52078","75726","23648","15.855","4.951"
"New Jersey","1983","474672","32379","15152","3.192","30.159","4303","11.674","2932","7.954","37546","1970","2001","10320","41231","45498","86729","18.271","8.686","51385","71577","20192","15.079","4.254"
"New Jersey","1984","493129","33452","27736","5.624","24.142","4833","12.753","3126","8.249","38749","2305","2338","11337","36252","51010","87262","17.696","7.351","41454","59526","18072","12.071","3.665"
"New Jersey","1985","508086","33081","14071","2.769","27.304","4388","11.488","4066","10.645","38356","3005","3043","15959","33300","50135","83435","16.421","6.554","40929","69364","28435","13.652","5.596"
"New Jersey","1986","513327","32488","3897","0.759","27.804","3968","10.512","3814","10.104","37824","2762","2797","13493","29005","46255","75260","14.661","5.65","49421","71363","21942","13.902","4.274"
"New Jersey","1987","522419","32323","-18352","-3.513","33.314","4181","11.144","3567","9.507","37826","2514","2556","13961","32414","54604","87018","16.657","6.205","80197","105370","25173","20.17","4.819"
"New Jersey","1988","527050","33011","23422","4.444","26.071","4386","11.445","3210","8.376","38911","2270","2303","12826","31759","60367","92126","17.48","6.026","43834","68704","24870","13.036","4.719"
"New Jersey","1989","549744","33339","29775","5.416","24.463","4413","11.32","3360","8.619","39510","2364","2430","14730","36683","60335","97018","17.648","6.673","42206","67243","25037","12.232","4.554"
"New Jersey","1990","574093","33701","22890","3.987","21.994","4119","10.414","3251","8.22","39986","2324","2369","13236","29370","56652","86022","14.984","5.116","42500","63132","20632","10.997","3.594"
"New Jersey","1991","587736","33677","5851","0.996","27.405","4301","10.748","3327","8.314","40505","2394","2445","18077","32349","54036","86385","14.698","5.504","54781","80534","25753","13.702","4.382"
"New Jersey","1992","591266","33996","8049","1.361","25.352","4134","10.222","3312","8.19","40852","2205","2257","12967","27865","55134","82999","14.038","4.713","51297","74950","23653","12.676","4.0"
"New Jersey","1993","603771","34431","17361","2.875","22.819","3988","9.727","3459","8.437","41262","2338","2414","11744","26667","59582","86249","14.285","4.417","47343","68888","21545","11.41","3.568"
"New Jersey","1994","622028","35003","15842","2.547","23.838","4302","10.326","3466","8.319","42081","2447","2500","13721","31623","58358","89981","14.466","5.084","47038","74139","27101","11.919","4.357"
"New Jersey","1995","644781","35417","32213","4.996","20.549","4123","9.742","3398","8.029","42683","2430","2484","12434","34499","63963","98462","15.271","5.35","44058","66249","22191","10.275","3.442"
"New Jersey","1996","665601","35543","17154","2.577","23.207","4182","9.808","3606","8.457","42927","2546","2606","13679","32445","61941","94386","14.181","4.875","50139","77232","27093","11.603","4.07"
"New Jersey","1997","677802","35829","9300","1.372","28.39","4401","10.235","3898","9.065","43252","2578","2657","16140","39963","65551","105514","15.567","5.896","65852","96214","30362","14.195","4.479"
"New Jersey","1998","701841","36147","22884","3.261","23.457","4191","9.626","3720","8.544","43773","2536","2612","15050","32726","72474","105200","14.989","4.663","53199","82316","29117","11.729","4.149"
"New Jersey","1999","721412","36282","15198","2.107","25.363","4019","9.165","3667","8.362","44027","2495","2587","20716","32735","73950","106685","14.788","4.538","56326","91487","35161","12.682","4.874"
"New Jersey","2000","740208","36501","22600","3.053","24.196","4237","9.584","3656","8.27","44500","2343","2422","11872","39142","73008","112150","15.151","5.288","60964","89550","28586","12.098","3.862"
"New Jersey","2001","746973","36571","-8986","-1.203","26.904","4281","9.596","3872","8.679","44816","2409","2493","15521","40526","59955","100481","13.452","5.425","73061","109467","36406","14.655","4.874"
"New Jersey","2002","741783","36609","-2697","-0.364","30.672","4578","10.185","4191","9.324","45144","2531","2585","17634","45086","68672","113758","15.336","6.078","80935","116455","35520","15.699","4.788"
"New Jersey","2003","748996","36970","17654","2.357","26.322","4414","9.737","3812","8.409","45631","2322","2361","11927","36269","79962","116231","15.518","4.842","68281","98577","30296","13.161","4.045"
"New Jersey","2004","756211","37261","-1562","-0.207","24.734","4135","9.04","3745","8.187","45937","2380","2439","12970","31834","61688","93522","12.367","4.21","70286","95084","24798","12.574","3.279"
"New Jersey","2005","763358","37689","13916","1.823","23.476","4377","9.47","3756","8.126","46532","2462","2518","13180","32014","71503","103517","13.561","4.194","63819","89601","25782","11.738","3.377"
"New Jersey","2006","777372","37819","14341","1.845","22.854","5112","10.935","4364","9.335","47121","3077","3143","15758","41159","62014","103173","13.272","5.295","60851","88832","27981","11.427","3.599"
"New Jersey","2007","787435","37861","6868","0.872","24.5","4477","9.486","4032","8.543","47418","2541","2556","13278","32097","71232","103329","13.122","4.076","67541","96461","28920","12.25","3.673"
"New Jersey","2008","793450","37636","1428","0.18","25.027","4158","8.784","4120","8.704","47356","2669","2697","13355","28381","72334","100715","12.693","3.577","72759","99287","26528","12.513","3.343"
"New Jersey","2009","787275","37366","-16119","-2.047","22.155","3685","7.798","3977","8.416","47111","2526","2581","15460","29652","57558","87210","11.077","3.766","72702","103329","30627","13.125","3.89"
"New Jersey","2010","774537","37337","-8709","-1.124","20.457","3743","7.941","3542","7.515","47233","2166","2227","11556","23955","55267","79222","10.228","3.093","67522","87931","20409","11.353","2.635"
"New Jersey","2011","757089","37106","4500","0.594","21.225","3862","8.191","3813","8.087","47174","2356","2405","11518","24312","60535","84847","11.207","3.211","56707","80347","23640","10.613","3.122"
"New Jersey","2012","766226","37425","16860","2.2","20.192","3908","8.266","3492","7.386","47488","2109","2153","10364","26340","67877","94217","12.296","3.438","56873","77357","20484","10.096","2.673"
"New Jersey","2013","776579","37391","2598","0.335","21.823","3833","8.072","3580","7.539","47614","2211","2237","12685","23901","63435","87336","11.246","3.078","58897","84738","25841","10.912","3.328"
"New Jersey","2014","786213","37850","16937","2.154","17.649","3931","8.209","3220","6.724","48241","2019","2078","10114","24584","61732","86316","10.979","3.127","48571","69379","20808","8.824","2.647"
"New Jersey","2015","802017","38148","17974","2.241","18.538","4103","8.456","3384","6.975","48879","2164","2202","11204","29085","63227","92312","11.51","3.626","53224","74338","21114","9.269","2.633"
"New Jersey","2016","818310","38629","14258","1.742","18.24","4160","8.454","3315","6.737","49629","2181","2245","12083","27806","61080","88886","10.862","3.398","52784","74628","21844","9.12","2.669"
"New Jersey","2017","827151","38843","7827","0.946","21.893","4067","8.184","3713","7.472","49871","2396","2452","16386","28009","70362","98371","11.893","3.386","59420","90544","31124","10.946","3.763"
"New Jersey","2018","836511","38774","11286","1.349","20.278","3706","7.453","3815","7.672","49669","2689","2774","14554","26600","69501","96101","11.488","3.18","56180","84815","28635","10.139","3.423"
"New Mexico","1978","262518","14463","45278","17.248","30.467","3406","21.588","2144","13.589","16408","1467","1479","11090","32881","52388","85269","32.481","12.525","18169","39991","21822","15.234","8.313"
"New Mexico","1979","307624","15609","35609","11.575","33.075","3617","21.251","2103","12.356","17777","1427","1438","11226","33916","52566","86482","28.113","11.025","26698","50873","24175","16.537","7.859"
"New Mexico","1980","331602","16129","14099","4.252","34.809","3384","18.742","2448","13.558","18524","1785","1813","11297","32241","39571","71812","21.656","9.723","38915","57713","18798","17.404","5.669"
"New Mexico","1981","344443","16753","14294","4.15","35.944","3321","17.659","2280","12.123","19327","1516","1549","9850","32460","43737","76197","22.122","9.424","44292","61903","17611","17.972","5.113"
"New Mexico","1982","348018","16885","1447","0.416","40.217","3302","17.031","2764","14.256","19657","1921","1937","14942","31365","40063","71428","20.524","9.012","46143","69981","23838","20.108","6.85"
"New Mexico","1983","341711","17273","-10244","-2.998","35.194","3168","16.099","2380","12.095","20072","1602","1625","10418","26937","33193","60130","17.597","7.883","52378","70374","17996","20.595","5.266"
"New Mexico","1984","353013","18375","38928","11.027","24.025","3700","18.02","2171","10.573","21297","1514","1529","8305","31205","50129","81334","23.04","8.84","28388","42406","14018","12.013","3.971"
"New Mexico","1985","378033","18787","18890","4.997","31.735","3514","16.511","2695","12.663","21692","1882","1904","13918","26880","51994","78874","20.864","7.11","33451","59984","26533","15.867","7.019"
"New Mexico","1986","395650","19091","18726","4.733","31.216","3694","17.034","2705","12.473","22181","1922","1951","13514","31478","49002","80480","20.341","7.956","36264","61754","25490","15.608","6.443"
"New Mexico","1987","422187","19933","37944","8.987","31.454","4125","18.347","2785","12.387","23153","1861","1889","14349","41641","62700","104341","24.714","9.863","42190","66397","24207","15.727","5.734"
"New Mexico","1988","454732","21077","23048","5.068","38.724","4334","18.154","2666","11.167","24708","1892","1915","15469","40918","70176","111094","24.431","8.998","51683","88046","36363","19.362","7.997"
"New Mexico","1989","485022","22257","43935","9.058","30.653","4424","17.536","2670","10.583","26105","1880","1923","16281","40979","77293","118272","24.385","8.449","45221","74337","29116","15.327","6.003"
"New Mexico","1990","522922","23366","41025","7.845","28.76","4479","16.861","2815","10.597","27396","2066","2095","18944","37699","78522","116221","22.225","7.209","49171","75196","26025","14.38","4.977"
"New Mexico","1991","534372","24065","5343","1.0","34.9","4636","16.66","3072","11.04","28609","2181","2216","18171","40494","58096","98590","18.45","7.578","65538","93247","27709","17.45","5.185"
"New Mexico","1992","536932","24431","10819","2.015","31.905","4360","15.237","3266","11.414","29162","2195","2220","14175","41196","55277","96473","17.967","7.672","60171","85654","25483","15.953","4.746"
"New Mexico","1993","550949","25202","20732","3.763","29.27","4403","14.962","3687","12.529","29786","2343","2384","17206","36102","65262","101364","18.398","6.553","49274","80632","31358","14.635","5.692"
"New Mexico","1994","597360","26645","56453","9.45","26.106","5129","16.739","3351","10.936","31530","2324","2373","20859","46464","87962","134426","22.503","7.778","47288","77973","30685","13.053","5.137"
"New Mexico","1995","640837","28131","43166","6.736","25.214","5405","16.705","3509","10.845","33303","2515","2571","18901","51398","72559","123957","19.343","8.02","54975","80791","25816","12.607","4.028"
"New Mexico","1996","676301","29075","41659","6.16","29.603","5558","16.422","3966","11.718","34641","2763","2815","22297","61844","79919","141763","20.962","9.144","61910","100104","38194","14.802","5.647"
"New Mexico","1997","726845","30481","43621","6.001","31.001","6423","18.077","4461","12.555","36512","2906","2969","19873","61569","94718","156287","21.502","8.471","72219","112666","40447","15.501","5.565"
"New Mexico","1998","786585","31957","50338","6.4","29.074","6249","16.647","4277","11.394","38524","2804","2835","18253","72947","91736","164683","20.936","9.274","76074","114345","38271","14.537","4.865"
"New Mexico","1999","832367","33252","40084","4.816","32.151","6704","16.98","4572","11.58","40547","3012","3114","21991","72083","101808","173891","20.891","8.66","82138","133807","51669","16.075","6.207"
"New Mexico","2000","882506","34262","60264","6.829","27.68","6555","15.922","5086","12.354","41904","3232","3297","21628","67747","114656","182403","20.669","7.677","79910","122139","42229","13.84","4.785"
"New Mexico","2001","922049","34920","21183","2.297","30.92","6542","15.456","5463","12.907","42865","3549","3635","26462","63706","100025","163731","17.757","6.909","94052","142548","48496","15.46","5.26"
"New Mexico","2002","932549","35522","-6856","-0.735","39.471","7016","16.145","5697","13.109","44117","3622","3699","29024","80609","103436","184045","19.736","8.644","128089","190901","62812","20.471","6.736"
"New Mexico","2003","949514","37125","37728","3.973","28.748","7334","16.3","5378","11.952","45973","3463","3509","23015","61487","112723","174210","18.347","6.476","91900","136482","44582","14.374","4.695"
"New Mexico","2004","994607","38598","51190","5.147","26.537","7498","16.032","5517","11.796","47760","3567","3671","26518","66082","117077","183159","18.415","6.644","80406","131969","51563","13.268","5.184"
"New Mexico","2005","1050770","40237","61750","5.877","26.453","7986","16.398","5688","11.68","49849","3815","3896","31755","71393","129335","200728","19.103","6.794","83210","138978","55768","13.226","5.307"
"New Mexico","2006","1120656","42521","73336","6.544","26.453","9345","18.192","6131","11.935","52977","4448","4499","30211","86681","134877","221558","19.77","7.735","99188","148222","49034","13.226","4.375"
"New Mexico","2007","1172923","43603","24190","2.062","33.593","8605","16.003","6647","12.361","54751","4421","4467","29101","81728","139473","221201","18.859","6.968","132457","197011","64554","16.797","5.504"
"New Mexico","2008","1168320","43239","-32948","-2.82","30.806","7604","13.906","7470","13.661","54748","5174","5282","32950","70874","109081","179955","15.403","6.066","150331","212903","62572","18.223","5.356"
"New Mexico","2009","1097819","41667","-114230","-10.405","24.891","6602","12.212","8211","15.188","53258","5489","5639","36717","55935","80693","136628","12.445","5.095","188805","250858","62053","22.851","5.652"
"New Mexico","2010","1019397","40625","-46911","-4.602","27.116","6472","12.279","7342","13.93","52273","4742","4843","31131","59599","78613","138212","13.558","5.846","132398","185123","52725","18.16","5.172"
"New Mexico","2011","997435","40578","-2703","-0.271","26.826","6491","12.399","6450","12.32","52373","4279","4371","29416","44126","89662","133788","13.413","4.424","89826","136491","46665","13.684","4.679"
"New Mexico","2012","1004799","40918","18453","1.836","24.867","6449","12.289","6038","11.506","52683","3792","3946","27391","48100","95285","143385","14.27","4.787","77223","124932","47709","12.434","4.748"
"New Mexico","2013","1025857","41459","27519","2.683","24.852","6496","12.287","5732","10.842","53249","3720","3810","24916","54233","100758","154991","15.108","5.287","79580","127472","47892","12.426","4.668"
"New Mexico","2014","1062673","42477","41825","3.936","20.504","6925","12.844","5409","10.032","54675","3608","3646","21374","51222","99550","150772","14.188","4.82","69716","108947","39231","10.252","3.692"
"New Mexico","2015","1103018","43570","41290","3.743","22.33","7121","12.841","5455","9.837","56287","3675","3747","22929","66013","98430","164443","14.908","5.985","84936","123153","38217","11.165","3.465"
"New Mexico","2016","1143182","44714","30342","2.654","22.136","7173","12.563","5460","9.562","57955","3754","3847","29144","55860","101012","156872","13.722","4.886","81396","126530","45134","11.068","3.948"
"New Mexico","2017","1171946","45314","31643","2.7","23.358","6835","11.726","6021","10.329","58698","4053","4122","24912","53234","115279","168513","14.379","4.542","86312","136870","50558","11.679","4.314"
"New Mexico","2018","1203585","46488","30289","2.517","22.101","7056","11.906","5786","9.763","59900","4197","4321","25192","57111","106182","163293","13.567","4.745","91137","133004","41867","11.051","3.479"
"New York","1978","273430","17567","31764","11.617","23.268","3119","16.394","1982","10.418","19594","1391","1417","6570","25895","37680","63575","23.251","9.47","18812","31811","12999","11.634","4.754"
"New York","1979","304229","18274","28440","9.348","23.366","2876","14.415","1908","9.563","20436","1329","1340","6323","21501","42482","63983","21.031","7.067","21287","35543","14256","11.683","4.686"
"New York","1980","322206","18098","4496","1.395","30.086","2450","12.078","2441","12.033","20290","1602","1614","9409","19549","33417","52966","16.439","6.067","31285","48470","17185","15.043","5.334"
"New York","1981","328146","18506","6478","1.974","27.265","2630","12.844","1967","9.606","20808","1286","1323","5502","19290","31923","51213","15.607","5.878","33877","44735","10858","13.633","3.309"
"New York","1982","337145","18604","13689","4.06","30.821","2819","13.517","2372","11.374","21078","1600","1621","8519","25148","40496","65644","19.471","7.459","32584","51955","19371","15.41","5.746"
"New York","1983","338494","19345","4083","1.206","30.095","2954","13.834","1841","8.622","21909","1248","1267","7159","20566","34452","55018","16.254","6.076","36759","50935","14176","15.048","4.188"
"New York","1984","362259","20913","43031","11.879","21.385","3679","16.239","1788","7.892","23601","1285","1312","7479","31593","50173","81766","22.571","8.721","25342","38735","13393","10.693","3.697"
"New York","1985","392594","22255","26795","6.825","28.332","4027","16.656","2268","9.381","25057","1665","1690","13447","28044","54366","82410","20.991","7.143","33856","55615","21759","14.166","5.542"
"New York","1986","413561","23814","19937","4.821","32.087","4649","18.063","2501","9.717","26812","1835","1856","11459","34848","51438","86286","20.864","8.426","40467","66349","25882","16.043","6.258"
"New York","1987","438359","25505","12506","2.853","35.141","5108","18.421","2860","10.314","28853","2062","2094","14787","35778","53750","89528","20.423","8.162","52054","77022","24968","17.571","5.696"
"New York","1988","456519","26837","21264","4.658","30.624","4926","16.623","3230","10.9","30482","2392","2413","14657","35407","55760","91167","19.97","7.756","44972","69903","24931","15.312","5.461"
"New York","1989","469198","27121","7285","1.553","30.157","4345","14.222","3504","11.469","30972","2743","2777","15428","30223","47810","78033","16.631","6.441","47955","70748","22793","15.079","4.858"
"New York","1990","462399","26164","-15757","-3.408","29.321","3657","12.042","4104","13.514","30146","3183","3239","18121","29707","38084","67791","14.661","6.425","55694","83548","27854","18.068","6.024"
"New York","1991","435120","24930","-30162","-6.932","26.11","3452","11.723","4008","13.611","29168","2916","2969","18294","26034","30771","56805","13.055","5.983","55520","86967","31447","19.987","7.227"
"New York","1992","419270","24640","6619","1.579","29.445","3440","11.892","3182","11.0","29055","2192","2233","11009","24659","43686","68345","16.301","5.881","42947","61726","18779","14.722","4.479"
"New York","1993","427020","24901","10594","2.481","26.759","3357","11.525","3028","10.395","29293","2014","2070","9392","22751","44977","67728","15.861","5.328","38815","57134","18319","13.38","4.29"
"New York","1994","444021","25498","18948","4.267","24.561","3600","12.143","2886","9.735","30003","1949","1981","11340","23622","49854","73476","16.548","5.32","34448","54528","20080","12.281","4.522"
"New York","1995","461757","26334","21611","4.68","22.869","3798","12.469","2736","8.982","30991","1910","2001","11231","27812","46598","74410","16.115","6.023","34643","52799","18156","11.434","3.932"
"New York","1996","471188","26894","14186","3.011","24.115","3751","12.012","2895","9.271","31655","1962","2036","11518","23348","47651","70999","15.068","4.955","37733","56813","19080","12.057","4.049"
"New York","1997","488321","27381","14703","3.011","26.213","3749","11.749","3116","9.765","32225","2034","2079","11664","25813","52893","78706","16.118","5.286","40683","64003","23320","13.107","4.776"
"New York","1998","509824","28012","22947","4.501","23.9","3503","10.769","2918","8.971","32820","1872","1909","10282","25487","58383","83870","16.451","4.999","40763","60923","20160","11.95","3.954"
"New York","1999","525965","28304","12107","2.302","23.609","3469","10.481","2813","8.499","33427","1911","1961","10260","25103","49091","74194","14.106","4.773","43269","62087","18818","11.804","3.578"
"New York","2000","545431","28458","25258","4.631","24.853","3378","10.086","3061","9.139","33652","1907","1970","11893","29872","63165","93037","17.058","5.477","43220","67779","24559","12.427","4.503"
"New York","2001","557146","28541","6948","1.247","25.282","3361","9.985","3102","9.216","33790","1989","2064","11352","27768","49610","77378","13.888","4.984","47433","70430","22997","12.641","4.128"
"New York","2002","556981","28413","-16502","-2.963","28.66","3566","10.534","3413","10.082","33928","2161","2218","18855","31162","48654","79816","14.33","5.595","64060","96318","32258","17.293","5.792"
"New York","2003","544703","28520","-6551","-1.203","27.309","3484","10.255","3231","9.511","34099","2087","2129","12361","25676","48700","74376","13.654","4.714","57145","80927","23782","14.857","4.366"
"New York","2004","545836","29031","8643","1.583","22.066","3639","10.583","2961","8.611","34724","1967","2016","11342","22037","46827","68864","12.616","4.037","40156","60221","20065","11.033","3.676"
"New York","2005","550555","29351","2945","0.535","24.665","3724","10.653","3141","8.985","35249","2176","2198","12817","27004","43839","70843","12.868","4.905","47180","67898","20718","12.333","3.763"
"New York","2006","562463","29588","18621","3.311","23.436","3953","11.148","3372","9.51","35749","2389","2425","11150","28470","56060","84530","15.029","5.062","45007","65909","20902","11.718","3.716"
"New York","2007","571797","29417","-1477","-0.258","25.975","3578","10.017","3457","9.679","35778","2291","2307","11574","22195","52066","74261","12.987","3.882","55163","75738","20575","13.246","3.598"
"New York","2008","579360","28924","17461","3.014","25.933","3161","8.9","3536","9.955","35331","2356","2392","10651","26352","66233","92585","15.981","4.548","52920","75124","22204","12.967","3.833"
"New York","2009","577566","27998","-27179","-4.706","19.717","2778","7.962","3755","10.762","34403","2357","2401","12195","17380","39558","56938","9.858","3.009","63789","84117","20328","14.564","3.52"
"New York","2010","562316","27720","-2306","-0.41","23.804","2914","8.516","3151","9.209","34099","1942","1990","9749","19886","47042","66928","11.902","3.536","51347","69234","17887","12.312","3.181"
"New York","2011","558522","27343","-6535","-1.17","20.809","2798","8.251","3025","8.921","33796","1939","1967","9187","17198","40913","58111","10.404","3.079","47097","64646","17549","11.574","3.142"
"New York","2012","550721","27440","-5635","-1.023","22.467","3042","8.989","2809","8.3","33959","1688","1734","10169","18645","43220","61865","11.233","3.386","40380","67500","27120","12.257","4.924"
"New York","2013","548669","27367","2780","0.507","22.03","2873","8.463","2732","8.047","34020","1721","1745","8497","19499","43716","63215","11.522","3.554","40684","60435","19751","11.015","3.6"
"New York","2014","556414","27292","15119","2.717","17.967","2904","8.513","2623","7.689","34254","1694","1734","8063","25082","40023","65105","11.701","4.508","34712","49986","15274","8.984","2.745"
"New York","2015","570118","27278","13709","2.405","17.998","2803","8.173","2602","7.587","34396","1671","1699","8026","18150","46863","65013","11.403","3.184","37574","51304","13730","8.999","2.408"
"New York","2016","585724","27623","17430","2.976","16.679","3025","8.728","2380","6.867","34982","1676","1701","8009","18886","47390","66276","11.315","3.224","35356","48846","13490","8.339","2.303"
"New York","2017","597821","27467","9430","1.577","19.815","2627","7.53","2705","7.753","34849","1746","1777","9159","19744","48915","68659","11.485","3.303","41734","59229","17495","9.907","2.926"
"New York","2018","607467","27565","9792","1.612","19.693","2694","7.726","2550","7.313","34941","1897","1921","10002","23051","46555","69606","11.458","3.795","43102","59814","16712","9.846","2.751"
"North Carolina","1978","2344967","129423","131775","5.619","29.27","19424","13.401","15644","10.793","146839","10233","10322","66675","160942","314014","474956","20.254","6.863","189990","343181","153191","14.635","6.533"
"North Carolina","1979","2460578","133696","126159","5.127","26.016","19216","12.92","13254","8.911","151713","8649","8698","44893","149295","296942","446237","18.135","6.067","208862","320078","111216","13.008","4.52"
"North Carolina","1980","2535878","134803","18235","0.719","29.846","17717","11.663","14632","9.632","153456","10209","10293","54856","137999","258669","396668","15.642","5.442","263955","378433","114478","14.923","4.514"
"North Carolina","1981","2564849","136244","49326","1.923","27.896","17239","11.211","13820","8.987","155481","8615","8755","39322","139435","267638","407073","15.871","5.436","251601","357747","106146","13.948","4.138"
"North Carolina","1982","2597021","136298","27534","1.06","30.589","17702","11.423","15593","10.062","156024","10765","10894","52812","154320","270409","424729","16.354","5.942","278757","397195","118438","15.294","4.561"
"North Carolina","1983","2609468","140340","52912","2.028","29.853","19315","12.301","12908","8.22","160229","8837","8923","48316","144928","297492","442420","16.954","5.554","279657","389508","109851","14.927","4.21"
"North Carolina","1984","2706869","145040","188817","6.975","24.57","20753","12.814","13230","8.169","165721","9415","9518","51285","167262","354091","521353","19.26","6.179","232823","332536","99713","12.285","3.684"
"North Carolina","1985","2845868","148970","151156","5.311","27.787","22329","13.387","15449","9.262","170239","11168","11364","75037","176164","370379","546543","19.205","6.19","260286","395387","135101","13.893","4.747"
"North Carolina","1986","2918635","152488","70818","2.426","30.818","22641","13.284","16089","9.44","173708","11421","11558","66763","178982","341565","520547","17.835","6.132","315596","449729","134133","15.409","4.596"
"North Carolina","1987","3048983","157136","109168","3.58","34.081","25195","14.352","17193","9.794","179546","12181","12306","77791","242142","386581","628723","20.621","7.942","359112","519555","160443","17.04","5.262"
"North Carolina","1988","3157635","162883","43609","1.381","32.862","25698","14.028","17847","9.742","187122","13025","13180","79055","209551","352896","562447","17.812","6.636","361751","518838","157087","16.431","4.975"
"North Carolina","1989","3208657","165048","83195","2.593","30.355","24251","12.923","18900","10.071","190338","13870","14090","81234","204152","366029","570181","17.77","6.363","340155","486986","146831","15.177","4.576"
"North Carolina","1990","3248180","165079","18990","0.585","30.915","22913","12.064","19705","10.375","191537","14603","14784","85938","199256","321816","521072","16.042","6.134","355315","502082","146767","15.457","4.518"
"North Carolina","1991","3151118","160846","-135084","-4.287","28.371","21347","11.316","21946","11.633","188351","15602","15847","101951","168338","278663","447001","14.185","5.342","412759","582085","169326","18.472","5.374"
"North Carolina","1992","3057071","159267","-20003","-0.654","30.484","19935","10.699","19648","10.545","186471","13164","13331","74286","143078","322878","465956","15.242","4.68","340672","485959","145287","15.896","4.752"
"North Carolina","1993","3061862","161782","43663","1.426","30.099","21336","11.39","18597","9.928","188694","12446","12712","72124","162786","341670","504456","16.475","5.317","310828","460793","149965","15.049","4.898"
"North Carolina","1994","3097337","163629","18389","0.594","29.474","21710","11.435","19148","10.085","191138","12973","13256","82618","163499","311348","474847","15.331","5.279","294650","456458","161808","14.737","5.224"
"North Carolina","1995","3148672","167940","104521","3.32","26.314","23487","12.148","18205","9.416","195981","12708","12970","78599","190859","327938","518797","16.477","6.062","268030","414276","146246","13.157","4.645"
"North Carolina","1996","3166034","169260","2288","0.072","31.343","22618","11.531","19879","10.134","197524","13831","14096","80180","179977","318482","498459","15.744","5.685","319692","496171","176479","15.672","5.574"
"North Carolina","1997","3224908","171755","94949","2.944","31.816","24812","12.492","21633","10.892","200208","14261","14649","98752","220026","387937","607963","18.852","6.823","309400","513014","203614","15.908","6.314"
"North Carolina","1998","3350339","174728","78451","2.342","30.284","23409","11.586","19782","9.791","203852","12770","12974","78376","196102","389653","585755","17.483","5.853","323493","507304","183811","15.142","5.486"
"North Carolina","1999","3417712","175471","54750","1.602","29.095","22230","10.884","20338","9.958","205192","13336","13647","88872","193626","358324","551950","16.15","5.665","327389","497200","169811","14.548","4.969"
"North Carolina","2000","3484460","175890","96721","2.776","28.622","22302","10.841","20366","9.899","206696","13111","13409","78621","194342","401043","595385","17.087","5.577","314853","498664","183811","14.311","5.275"
"North Carolina","2001","3570322","176804","83865","2.349","28.681","22666","10.929","20321","9.799","208561","13165","13435","80156","202527","393344","595871","16.69","5.673","341749","512006","170257","14.341","4.769"
"North Carolina","2002","3603897","176372","-46794","-1.298","33.786","24180","11.578","22962","10.995","209445","14623","14928","104719","220782","388029","608811","16.893","6.126","439712","655605","215893","18.192","5.991"
"North Carolina","2003","3569528","176979","-12642","-0.354","30.915","23229","11.081","22184","10.583","210149","14253","14459","89929","177495","374271","551766","15.458","4.973","376435","564408","187973","15.812","5.266"
"North Carolina","2004","3588870","179440","35221","0.981","29.018","23739","11.261","22016","10.443","211678","13888","14057","81022","171369","384563","555932","15.49","4.775","330005","520711","190706","14.509","5.314"
"North Carolina","2005","3593758","181337","-24771","-0.689","28.112","24723","11.623","22106","10.392","214025","14649","14835","87159","180790","324341","505131","14.056","5.031","340771","529902","189131","14.745","5.263"
"North Carolina","2006","3622548","183941","79138","2.185","26.617","26692","12.36","22112","10.239","218244","15558","15705","78973","207921","353315","561236","15.493","5.74","322513","482098","159585","13.308","4.405"
"North Carolina","2007","3652649","183441","-17083","-0.468","29.144","24420","11.205","23989","11.007","218160","15779","15901","80361","177968","354304","532272","14.572","4.872","369157","549355","180198","15.04","4.933"
"North Carolina","2008","3614291","180134","-45636","-1.263","27.709","21385","9.879","24066","11.118","215128","16435","16625","91239","167586","333157","500743","13.855","4.637","357669","546379","188710","15.117","5.221"
"North Carolina","2009","3506864","173666","-184491","-5.261","22.39","19085","8.997","25951","12.234","208697","16986","17252","89866","140654","251947","392601","11.195","4.011","414784","577092","162308","16.456","4.628"
"North Carolina","2010","3385831","170366","-59120","-1.746","23.276","19420","9.396","22712","10.988","205044","14226","14417","76369","137439","256611","394050","11.638","4.059","304007","453170","149163","13.384","4.406"
"North Carolina","2011","3364186","169147","18021","0.536","23.892","20110","9.841","20784","10.171","204018","13426","13606","63825","123787","296125","419912","12.482","3.68","270424","401891","131467","11.946","3.908"
"North Carolina","2012","3403717","170951","54655","1.606","23.703","21412","10.461","19252","9.406","205758","12158","12371","63563","135867","322171","458038","13.457","3.992","271820","403383","131563","11.851","3.865"
"North Carolina","2013","3450343","171225","43430","1.259","24.527","20746","10.079","19688","9.565","206362","12735","12934","73114","135540","331025","466565","13.522","3.928","278933","423135","144202","12.264","4.179"
"North Carolina","2014","3486440","171212","32684","0.937","23.163","20673","10.006","19467","9.422","207211","13063","13240","66985","147249","289217","436466","12.519","4.223","280896","403782","122886","11.581","3.525"
"North Carolina","2015","3518897","170560","49288","1.401","23.88","19995","9.658","19714","9.522","207175","13308","13504","81886","161682","307755","469437","13.34","4.595","280045","420149","140104","11.94","3.981"
"North Carolina","2016","3583162","171839","77949","2.175","22.142","21084","10.122","18371","8.82","209648","13031","13170","73516","147278","327361","474639","13.246","4.11","268177","396690","128513","11.071","3.587"
"North Carolina","2017","3632845","171544","59416","1.636","24.472","20256","9.668","19859","9.479","209712","13621","13827","77211","164224","339701","503925","13.871","4.521","305701","444509","138808","12.236","3.821"
"North Carolina","2018","3692305","171508","56919","1.542","22.661","18861","9.005","18842","8.996","209457","14195","14381","67800","148368","326906","475274","12.872","4.018","292848","418355","125507","11.33","3.399"
"North Dakota","1978","289830","22007","33191","11.452","34.943","4728","18.96","3603","14.449","25499","2532","2550","15482","32310","51518","83828","28.923","11.148","25504","50637","25133","17.471","8.672"
"North Dakota","1979","319010","22812","22191","6.956","34.138","4381","16.96","3295","12.756","26374","2106","2135","11811","29906","46736","76642","24.025","9.375","30440","54451","24011","17.069","7.527"
"North Dakota","1980","328664","22836","-230","-0.07","38.953","4043","15.341","3605","13.679","26573","2541","2570","14287","27515","36497","64012","19.476","8.372","41486","64242","22756","19.546","6.924"
"North Dakota","1981","330815","23213","9641","2.914","35.963","3975","14.893","3199","11.985","27079","2126","2149","10203","27390","41736","69126","20.896","8.28","38734","59485","20751","17.981","6.273"
"North Dakota","1982","341575","23398","13171","3.856","35.6","4236","15.599","3548","13.065","27500","2432","2461","12507","29638","44333","73971","21.656","8.677","39590","60800","21210","17.8","6.209"
"North Dakota","1983","343550","24572","-3597","-1.047","39.303","4573","16.386","2940","10.534","28725","1981","2019","12772","28261","39252","67513","19.652","8.226","49939","71110","21171","20.699","6.162"
"North Dakota","1984","357595","25772","31296","8.752","30.962","4845","16.626","3192","10.954","29967","2275","2310","11479","39549","47106","86655","24.233","11.06","37431","55359","17928","15.481","5.013"
"North Dakota","1985","383893","26048","30702","7.998","34.441","4582","15.346","3786","12.68","30256","2660","2694","15811","43980","52830","96810","25.218","11.456","38356","66108","27752","17.22","7.229"
"North Dakota","1986","394695","26115","-1461","-0.37","37.841","4642","15.405","3775","12.528","30566","2675","2719","15191","33610","41069","74679","18.921","8.515","49517","76140","26623","19.291","6.745"
"North Dakota","1987","395520","26128","-12742","-3.222","42.344","4516","14.865","3922","12.909","30678","2631","2683","14823","36828","46911","83739","21.172","9.311","70095","96481","26386","24.393","6.671"
"North Dakota","1988","393170","26556","8206","2.087","36.459","4647","14.988","3757","12.118","31449","2604","2654","16878","31914","47964","79878","20.316","8.117","44324","71672","27348","18.229","6.956"
"North Dakota","1989","400611","26881","11691","2.918","32.991","4585","14.549","3580","11.36","32016","2559","2620","15083","31199","46574","77773","19.414","7.788","41715","66082","24367","16.495","6.082"
"North Dakota","1990","413476","27478","19492","4.714","29.094","4474","13.918","3432","10.677","32666","2388","2441","13765","32306","47335","79641","19.261","7.813","37730","60149","22419","14.547","5.422"
"North Dakota","1991","424499","27713","6896","1.625","35.549","4567","13.963","3604","11.019","33190","2482","2543","16320","34808","47541","82349","19.399","8.2","46860","75453","28593","17.775","6.736"
"North Dakota","1992","431709","27952","14218","3.293","32.46","4329","13.052","3442","10.377","33612","2248","2290","12904","32200","52085","84285","19.524","7.459","47681","70067","22386","16.23","5.185"
"North Dakota","1993","448280","28892","18292","4.08","29.901","4317","12.717","3435","10.119","34387","2236","2279","11741","28157","57155","85312","19.031","6.281","43340","67020","23680","14.95","5.282"
"North Dakota","1994","470019","29821","21252","4.522","28.797","4767","13.628","3518","10.057","35605","2462","2501","14007","31634","57293","88927","18.92","6.73","43605","67675","24070","14.398","5.121"
"North Dakota","1995","490727","30633","23980","4.887","26.854","4787","13.283","3685","10.225","36590","2601","2657","15023","33930","55941","89871","18.314","6.914","40741","65891","25150","13.427","5.125"
"North Dakota","1996","500447","31025","12983","2.594","30.887","4704","12.788","3833","10.42","37219","2641","2684","15337","32896","57373","90269","18.038","6.573","49194","77286","28092","15.443","5.613"
"North Dakota","1997","512115","31124","7326","1.431","34.961","4904","13.123","4375","11.708","37633","2891","2931","18828","38892","57954","96846","18.911","7.594","57661","89520","31859","17.48","6.221"
"North Dakota","1998","533666","31503","9236","1.731","30.82","4528","11.944","4048","10.678","38150","2612","2693","14708","34775","56699","91474","17.141","6.516","50972","82238","31266","15.41","5.859"
"North Dakota","1999","540388","31357","540","0.1","32.294","4433","11.602","4127","10.801","38361","2716","2777","16138","34212","53585","87797","16.247","6.331","58161","87257","29096","16.147","5.384"
"North Dakota","2000","547859","31193","10447","1.907","29.779","4313","11.254","4223","11.019","38370","2759","2830","15483","32176","59845","92021","16.796","5.873","51956","81574","29618","14.89","5.406"
"North Dakota","2001","555249","31172","5580","1.005","31.878","4447","11.599","4186","10.918","38471","2503","2560","14183","34210","59872","94082","16.944","6.161","57247","88502","31255","15.939","5.629"
"North Dakota","2002","555879","31287","-8207","-1.476","35.366","4654","12.069","4443","11.522","38668","2586","2653","17428","40230","58065","98295","17.683","7.237","71014","106502","35488","19.159","6.384"
"North Dakota","2003","561311","31728","19139","3.41","28.409","4432","11.404","3841","9.883","39159","2286","2339","12998","36222","62647","98869","17.614","6.453","50181","79730","29549","14.204","5.264"
"North Dakota","2004","575841","32202","10756","1.868","28.007","4357","11.063","3735","9.484","39695","2368","2399","12429","31017","60378","91395","15.872","5.386","51823","80639","28816","14.004","5.004"
"North Dakota","2005","594239","32733","9140","1.538","30.92","4602","11.487","3722","9.29","40504","2400","2453","15043","36675","64334","101009","16.998","6.172","67001","91869","24868","15.46","4.185"
"North Dakota","2006","615375","33541","33461","5.438","26.048","5431","13.238","4197","10.23","41644","2921","2957","16872","43197","70409","113606","18.461","7.02","51268","80145","28877","13.024","4.693"
"North Dakota","2007","630827","33969","2113","0.335","30.695","4838","11.531","3930","9.367","42409","2546","2588","14573","33418","65510","98928","15.682","5.297","67802","96815","29013","15.347","4.599"
"North Dakota","2008","637979","33714","-1279","-0.2","30.339","4308","10.195","4420","10.461","42198","2810","2872","16114","35005","61773","96778","15.169","5.487","65237","98057","32820","15.37","5.144"
"North Dakota","2009","625150","32864","-26667","-4.266","23.535","3677","8.786","4534","10.834","41420","2953","2994","15129","25832","47733","73565","11.768","4.132","74271","100232","25961","16.033","4.153"
"North Dakota","2010","603678","31997","-14975","-2.481","22.563","3492","8.531","4252","10.388","40553","2722","2770","12543","21600","46505","68105","11.282","3.578","60779","83080","22301","13.762","3.694"
"North Dakota","2011","594592","31670","-816","-0.137","23.577","3772","9.33","3818","9.443","40407","2495","2567","11343","21325","48767","70092","11.788","3.586","52114","70908","18794","11.925","3.161"
"North Dakota","2012","592860","31642","-2231","-0.376","25.148","3695","9.165","3630","9.004","40347","2207","2313","10452","23701","50845","74546","12.574","3.998","52679","76777","24098","12.95","4.065"
"North Dakota","2013","591939","31494","1824","0.308","26.429","3594","8.939","3616","8.993","40197","2284","2321","12946","28839","51207","80046","13.523","4.872","53884","78222","24338","13.215","4.112"
"North Dakota","2014","604341","31314","22568","3.734","21.642","3496","8.703","3385","8.427","40226","2254","2281","10687","40272","47693","87965","14.556","6.664","45601","65397","19796","10.821","3.276"
"North Dakota","2015","620547","31180","11589","1.868","21.201","3646","9.055","3410","8.469","40381","2188","2210","10113","27197","50174","77371","12.468","4.383","46536","65782","19246","10.601","3.101"
"North Dakota","2016","628014","31055","3199","0.509","22.688","3509","8.688","3361","8.322","40462","2251","2326","12259","26675","47766","74441","11.853","4.248","50474","71242","20768","11.344","3.307"
"North Dakota","2017","626422","30965","-1712","-0.273","23.947","3366","8.344","3454","8.563","40294","2251","2304","11307","23076","51930","75006","11.974","3.684","52860","76718","23858","12.247","3.809"
"North Dakota","2018","627472","30882","4332","0.69","21.478","3228","8.043","3395","8.459","40053","2420","2479","11899","22396","49320","71716","11.429","3.569","46469","67384","20915","10.739","3.333"
"Ohio","1978","5468658","313646","211803","3.873","30.277","44241","12.559","41003","11.64","353875","28679","29016","146324","350285","689384","1039669","19.011","6.405","471641","827866","356225","15.138","6.514"
"Ohio","1979","5668907","316929","280985","4.957","25.452","42071","11.895","33648","9.513","357902","23197","23479","118015","310518","691884","1002402","17.682","5.478","464523","721417","256894","12.726","4.532"
"Ohio","1980","5776126","314591","29819","0.516","28.693","39205","11.05","36008","10.149","356391","26053","26355","144751","285615","572876","858491","14.863","4.945","562236","828672","266436","14.347","4.613"
"Ohio","1981","5817500","317325","85395","1.468","27.826","39123","10.983","31155","8.746","360203","20577","20942","96072","290846","603930","894776","15.381","5.0","590047","809381","219334","13.913","3.77"
"Ohio","1982","5885417","315908","88675","1.507","28.983","40444","11.303","36936","10.323","359573","26343","26732","136224","345808","595764","941572","15.998","5.876","591541","852897","261356","14.492","4.441"
"Ohio","1983","5919907","324328","67843","1.146","30.292","44800","12.402","30855","8.542","368204","22147","22460","127417","334539","629939","964478","16.292","5.651","656436","896635","240199","15.146","4.057"
"Ohio","1984","6094837","330802","255878","4.198","26.115","45692","12.382","32902","8.916","375412","24414","24671","130797","352929","698794","1051723","17.256","5.791","575943","795845","219902","13.058","3.608"
"Ohio","1985","6254211","336474","257097","4.111","27.161","49125","13.089","36168","9.636","381804","27348","27732","166914","383339","723124","1106463","17.691","6.129","560772","849366","288594","13.581","4.614"
"Ohio","1986","6407295","339663","205774","3.212","27.954","48224","12.694","36956","9.728","385526","27414","27766","148814","385407","715924","1101331","17.189","6.015","604864","895557","290693","13.977","4.537"
"Ohio","1987","6607384","343808","248437","3.76","29.972","51705","13.412","39912","10.353","391397","29600","29877","177105","476213","762401","1238614","18.746","7.207","670563","990177","319614","14.986","4.837"
"Ohio","1988","6793253","352903","93136","1.371","31.502","53010","13.353","40159","10.116","403423","30109","30462","173307","392560","770580","1163140","17.122","5.779","740150","1070004","329854","15.751","4.856"
"Ohio","1989","6868090","357219","141785","2.064","28.617","52798","13.069","41097","10.172","409852","30951","31504","176555","399182","725339","1124521","16.373","5.812","669698","982736","313038","14.309","4.558"
"Ohio","1990","6955713","356767","81802","1.176","27.783","49231","12.054","42502","10.406","411799","32767","33284","186039","365130","682941","1048071","15.068","5.249","667933","966269","298336","13.892","4.289"
"Ohio","1991","6835067","350076","-305672","-4.472","26.67","47466","11.652","45206","11.097","408505","34175","34773","233265","372340","539122","911462","13.335","5.447","864637","1217134","352497","17.807","5.157"
"Ohio","1992","6603998","344819","-41561","-0.629","28.908","43570","10.815","43294","10.746","403009","31114","31542","172327","323569","630958","954527","14.454","4.9","695991","996088","300097","15.083","4.544"
"Ohio","1993","6539472","345471","-37423","-0.572","29.647","44966","11.168","43864","10.894","403195","30839","31432","170764","339103","630289","969392","14.824","5.185","680376","1006815","326439","15.396","4.992"
"Ohio","1994","6566685","346143","53759","0.819","28.83","45538","11.266","43461","10.753","405230","31024","31591","190599","354192","646158","1000350","15.234","5.394","609684","946591","336907","14.415","5.131"
"Ohio","1995","6604666","350733","71367","1.081","27.414","47360","11.621","41123","10.09","410663","29620","30209","175418","348057","628600","976657","14.787","5.27","610577","905290","294713","13.707","4.462"
"Ohio","1996","6597357","351765","24370","0.369","28.447","46706","11.383","43143","10.515","412083","31177","31892","189041","351544","611196","962740","14.593","5.329","616178","938370","322192","14.223","4.884"
"Ohio","1997","6702531","355074","117541","1.754","29.689","49433","11.954","45326","10.961","415580","31902","32555","195743","381863","730639","1112502","16.598","5.697","615079","994961","379882","14.845","5.668"
"Ohio","1998","6860558","360691","133209","1.942","29.209","46631","11.129","39658","9.465","422479","26632","27066","146113","357253","777920","1135173","16.546","5.207","667594","1001964","334370","14.605","4.874"
"Ohio","1999","6982006","362450","110477","1.582","26.975","45278","10.679","40517","9.556","426360","27530","28034","163778","349852","702312","1052164","15.07","5.011","623071","941687","318616","13.487","4.563"
"Ohio","2000","7164084","364906","211106","2.947","26.028","45699","10.674","40695","9.506","430622","26777","27409","159791","376654","766776","1143430","15.961","5.258","585042","932324","347282","13.014","4.848"
"Ohio","2001","7257680","367227","29781","0.41","27.82","46186","10.703","41888","9.707","433655","27002","27526","167777","362928","676404","1039332","14.32","5.001","661073","1009551","348478","13.91","4.802"
"Ohio","2002","7264493","367665","-191683","-2.639","32.375","50818","11.684","48445","11.139","436113","30722","31379","237273","490863","685072","1175935","16.187","6.757","848747","1367618","518871","18.826","7.143"
"Ohio","2003","7208222","372615","108750","1.509","27.445","49085","11.204","43609","9.954","440848","28709","29193","156727","340787","757117","1097904","15.231","4.728","669132","989154","320022","13.723","4.44"
"Ohio","2004","7322203","377705","63687","0.87","27.196","51159","11.533","44755","10.09","446773","29636","30094","162998","346569","712800","1059369","14.468","4.733","672697","995682","322985","13.598","4.411"
"Ohio","2005","7347032","382380","-18539","-0.252","27.048","50498","11.268","46531","10.382","450154","30642","31042","171346","363770","629842","993612","13.524","4.951","681745","1012151","330406","13.776","4.497"
"Ohio","2006","7416389","386173","136359","1.839","25.035","54246","11.97","46551","10.272","457030","33726","34102","176958","379144","685568","1064712","14.356","5.112","629147","928353","299206","12.518","4.034"
"Ohio","2007","7475868","387516","1607","0.021","28.252","51247","11.195","47380","10.35","459696","31755","32068","170288","354839","702814","1057653","14.148","4.746","696087","1056046","359959","14.126","4.815"
"Ohio","2008","7501739","387820","73939","0.986","25.376","48196","10.479","46187","10.042","460926","31464","31803","163466","331149","694613","1025762","13.674","4.414","647358","951823","304465","12.688","4.059"
"Ohio","2009","7419594","384382","-264087","-3.559","22.248","45430","9.879","49437","10.75","457876","32831","33223","178438","292394","532978","825372","11.124","3.941","775389","1089459","314070","14.684","4.233"
"Ohio","2010","7254209","385281","-67761","-0.934","23.539","47599","10.388","45672","9.968","459169","30287","30732","153524","303565","550209","853774","11.769","4.185","635586","921535","285949","12.703","3.942"
"Ohio","2011","7277791","387562","119463","1.641","22.56","49303","10.707","45296","9.837","462468","29968","30345","140581","299619","640791","940410","12.922","4.117","550748","820947","270199","11.28","3.713"
"Ohio","2012","7415412","393611","173456","2.339","21.477","49958","10.739","42766","9.193","468780","28504","28958","138013","288087","681683","969770","13.078","3.885","541539","796314","254775","10.739","3.436"
"Ohio","2013","7565350","396498","125544","1.659","22.43","48763","10.385","45314","9.651","471260","29685","30149","155331","305873","668127","974000","12.874","4.043","566796","848456","281660","11.215","3.723"
"Ohio","2014","7722282","399074","179401","2.323","21.603","49237","10.41","44252","9.356","475457","30613","30937","150568","347862","665663","1013525","13.125","4.505","567007","834124","267117","10.802","3.459"
"Ohio","2015","7888667","400948","152759","1.936","22.275","48259","10.129","45055","9.456","478048","30822","31297","155918","345427","685948","1031375","13.074","4.379","591384","878616","287232","11.138","3.641"
"Ohio","2016","8046386","405431","171807","2.135","20.98","50415","10.48","43110","8.961","484732","31503","31912","183490","313244","702622","1015866","12.625","3.893","549700","844059","294359","10.49","3.658"
"Ohio","2017","8168696","405839","105340","1.29","23.679","47560","9.812","46117","9.514","485443","32823","33264","182830","325839","746630","1072469","13.129","3.989","626527","967129","340602","11.839","4.17"
"Ohio","2018","8271995","406140","129845","1.57","21.866","45821","9.449","45434","9.369","485122","34904","35544","189152","318755","715453","1034208","12.503","3.853","605311","904363","299052","10.933","3.615"
"Oklahoma","1978","1786906","88747","139117","7.785","23.483","15989","15.27","11626","11.104","106887","7762","7834","35351","124311","224616","348927","19.527","6.957","125203","209810","84607","11.742","4.735"
"Oklahoma","1979","1917708","91847","106810","5.57","23.15","15117","13.92","10462","9.634","110926","7265","7356","39068","118882","209904","328786","17.145","6.199","137677","221976","84299","11.575","4.396"
"Oklahoma","1980","1977190","91684","5028","0.254","28.165","13742","12.392","12354","11.141","111586","8595","8740","44215","110777","172689","283466","14.337","5.603","182119","278438","96319","14.083","4.872"
"Oklahoma","1981","1981795","92310","16206","0.818","26.366","13368","11.951","11312","10.113","112886","7574","7696","36723","111795","165671","277466","14.001","5.641","178198","261260","83062","13.183","4.191"
"Oklahoma","1982","1990336","92021","755","0.038","28.972","14139","12.547","12753","11.317","113383","8811","8985","41162","124128","164949","289077","14.524","6.237","199749","288322","88573","14.486","4.45"
"Oklahoma","1983","1990732","94143","17357","0.872","28.71","15043","13.209","10948","9.614","115928","7738","7882","37585","121231","181895","303126","15.227","6.09","190589","285769","95180","14.355","4.781"
"Oklahoma","1984","2082507","101520","168951","8.113","20.953","20239","16.888","11813","9.857","124053","9164","9235","48230","132252","254871","387123","18.589","6.351","140422","218172","77750","10.476","3.733"
"Oklahoma","1985","2205190","105232","97497","4.421","25.77","17703","14.124","12016","9.587","128186","8610","8774","53530","138857","242777","381634","17.306","6.297","185063","284137","99074","12.885","4.493"
"Oklahoma","1986","2282489","108186","80414","3.523","26.541","18267","14.148","12359","9.572","132066","8631","8801","50111","147917","235397","383314","16.794","6.481","197142","302900","105758","13.271","4.633"
"Oklahoma","1987","2371582","110979","98713","4.162","28.43","19300","14.441","13071","9.78","136765","9036","9159","58240","171404","264425","435829","18.377","7.227","205823","337116","131293","14.215","5.536"
"Oklahoma","1988","2490427","115460","118702","4.766","27.184","20242","14.47","13344","9.539","143338","9083","9278","57277","186329","270866","457195","18.358","7.482","220021","338493","118472","13.592","4.757"
"Oklahoma","1989","2583764","118682","86991","3.367","26.731","19476","13.477","13678","9.465","147411","9399","9641","57325","169803","262519","432322","16.732","6.572","228109","345331","117222","13.365","4.537"
"Oklahoma","1990","2662087","121682","88006","3.306","25.238","19073","12.829","13687","9.206","151360","9858","10125","59030","151563","272370","423933","15.925","5.693","231058","335927","104869","12.619","3.939"
"Oklahoma","1991","2646424","120573","-90001","-3.401","26.84","18040","11.964","15819","10.491","151896","11158","11468","79750","150643","204502","355145","13.42","5.692","302293","445146","142853","16.821","5.398"
"Oklahoma","1992","2612313","120962","71977","2.755","25.559","16890","11.155","14363","9.486","152680","9484","9692","51929","139890","265925","405815","15.535","5.355","232163","333838","101675","12.779","3.892"
"Oklahoma","1993","2681273","123490","71163","2.654","25.422","17093","11.123","14016","9.12","155217","9246","9465","59024","129312","282663","411975","15.365","4.823","225989","340812","114823","12.711","4.282"
"Oklahoma","1994","2788095","127118","118393","4.246","23.273","18758","11.907","13832","8.78","160002","9496","9738","59233","156902","285931","442833","15.883","5.628","215871","324440","108569","11.637","3.894"
"Oklahoma","1995","2904685","131525","127889","4.403","22.619","19635","12.083","13647","8.398","165490","9458","9727","57318","156101","300297","456398","15.712","5.374","217995","328509","110514","11.31","3.805"
"Oklahoma","1996","2980042","134495","65932","2.212","26.063","20051","12.015","15030","9.006","169395","10062","10320","60536","173767","280502","454269","15.244","5.831","258406","388337","129931","13.031","4.36"
"Oklahoma","1997","3063619","138439","97821","3.193","27.665","23029","13.377","16390","9.521","175469","10608","10898","71174","194233","327365","521598","17.026","6.34","273004","423777","150773","13.833","4.921"
"Oklahoma","1998","3183613","141566","81878","2.572","27.043","21210","11.972","17534","9.897","178996","10710","10982","66939","189527","322816","512343","16.093","5.953","267852","430465","162613","13.521","5.108"
"Oklahoma","1999","3276143","143832","97715","2.983","27.986","21078","11.69","16989","9.422","182354","10970","11393","71988","198131","358007","556138","16.975","6.048","295073","458423","163350","13.993","4.986"
"Oklahoma","2000","3363780","144530","75686","2.25","26.852","19786","10.823","17526","9.587","183948","11286","11821","73459","181103","346206","527309","15.676","5.384","287993","451623","163630","13.426","4.864"
"Oklahoma","2001","3421401","145499","41925","1.225","30.01","20824","11.296","18340","9.948","185598","11374","11840","74043","195955","359344","555299","16.23","5.727","337521","513374","175853","15.005","5.14"
"Oklahoma","2002","3388181","145665","-126224","-3.725","30.037","21768","11.693","20060","10.776","187011","12086","12506","92791","211537","297325","508862","15.019","6.243","426542","635086","208544","18.744","6.155"
"Oklahoma","2003","3331327","146908","16331","0.49","29.762","20855","11.12","18632","9.934","188661","11363","11576","66377","178923","333136","512059","15.371","5.371","332142","495728","163586","14.881","4.911"
"Oklahoma","2004","3345354","149751","20785","0.621","27.979","21132","11.116","17446","9.177","191945","10969","11217","70781","159937","328850","488787","14.611","4.781","311091","468002","156911","13.99","4.69"
"Oklahoma","2005","3378997","153264","38922","1.152","27.694","22746","11.734","18084","9.329","196184","11657","11955","70864","187151","319662","506813","14.999","5.539","326739","467891","141152","13.847","4.177"
"Oklahoma","2006","3460945","156988","118652","3.428","26.019","26381","13.256","19319","9.707","202548","13501","13719","77660","223830","345082","568912","16.438","6.467","293995","450260","156265","13.01","4.515"
"Oklahoma","2007","3537845","159557","31958","0.903","29.089","24566","12.019","19716","9.646","206825","12346","12592","73387","190838","355688","546526","15.448","5.394","353388","514568","161180","14.545","4.556"
"Oklahoma","2008","3544090","158612","-4923","-0.139","28.158","21447","10.385","20815","10.079","206843","13824","14083","78459","168597","330379","498976","14.079","4.757","341786","503899","162113","14.218","4.574"
"Oklahoma","2009","3433320","152474","-231409","-6.74","21.331","18026","8.834","23957","11.74","201094","15592","15908","85823","143276","222909","366185","10.666","4.173","427410","597594","170184","17.406","4.957"
"Oklahoma","2010","3263780","150071","-89871","-2.754","23.464","19190","9.612","20849","10.443","198810","12666","13023","67414","145248","237655","382903","11.732","4.45","334792","472774","137982","14.485","4.228"
"Oklahoma","2011","3242053","148601","55319","1.706","22.795","18895","9.547","19543","9.874","197591","12321","12707","63888","133980","290844","424824","13.104","4.133","254057","369505","115448","11.397","3.561"
"Oklahoma","2012","3294438","149224","68029","2.065","22.644","19281","9.752","17711","8.957","198508","10629","10888","60649","127847","313174","441021","13.387","3.881","252868","372992","120124","11.322","3.646"
"Oklahoma","2013","3353460","149318","62603","1.867","22.472","18808","9.475","17455","8.794","199170","10858","11018","57201","142894","296497","439391","13.103","4.261","252789","376788","123999","11.236","3.698"
"Oklahoma","2014","3413941","149740","60481","1.772","20.992","18680","9.363","16908","8.474","200405","10829","11069","56942","129635","289178","418813","12.268","3.797","236060","358332","122272","10.496","3.582"
"Oklahoma","2015","3499299","151557","115598","3.303","19.682","19283","9.571","16101","7.992","203059","10105","10276","58842","148478","311488","459966","13.145","4.243","232506","344368","111862","9.841","3.197"
"Oklahoma","2016","3612697","154657","111225","3.079","20.139","20395","9.938","15169","7.392","207828","10252","10457","66722","152264","322744","475008","13.148","4.215","254244","363783","109539","10.07","3.032"
"Oklahoma","2017","3705175","157106","83674","2.258","21.582","20546","9.819","16761","8.01","211131","10854","11147","63980","147916","335585","483501","13.049","3.992","268654","399827","131173","10.791","3.54"
"Oklahoma","2018","3810231","159343","84611","2.221","21.171","19586","9.239","16949","7.995","213307","12059","12486","73932","153843","334104","487947","12.806","4.038","271278","403336","132058","10.586","3.466"
"Oregon","1978","149663","13326","14169","9.467","26.016","2089","14.078","1547","10.425","15110","1087","1093","5016","11155","22482","33637","22.475","7.453","11412","19468","8056","13.008","5.383"
"Oregon","1979","164011","13947","12506","7.625","27.515","2232","14.496","1474","9.573","15776","1027","1031","5436","14183","20887","35070","21.383","8.648","13552","22564","9012","13.758","5.495"
"Oregon","1980","171748","13987","3526","2.053","31.614","1969","12.459","1713","10.839","15932","1245","1251","5623","12025","18649","30674","17.86","7.002","18375","27148","8773","15.807","5.108"
"Oregon","1981","173734","14112","1503","0.865","30.82","1905","11.906","1481","9.256","16213","1058","1072","4824","11539","16736","28275","16.275","6.642","19683","26772","7089","15.41","4.08"
"Oregon","1982","176030","13990","3989","2.266","30.898","1934","12.027","1790","11.131","16153","1235","1253","5844","11729","19455","31184","17.715","6.663","18437","27195","8758","15.449","4.975"
"Oregon","1983","174162","14304","-1532","-0.88","31.789","1995","12.344","1376","8.514","16471","970","994","5572","11198","16484","27682","15.894","6.43","20927","29214","8287","16.774","4.758"
"Oregon","1984","176243","14843","8472","4.807","25.637","2224","13.362","1369","8.225","17072","1000","1010","4936","12654","18410","31064","17.626","7.18","15244","22592","7348","12.819","4.169"
"Oregon","1985","181094","14578","2692","1.487","29.842","1836","10.927","1824","10.855","16809","1332","1358","7014","11310","18403","29713","16.408","6.245","17129","27021","9892","14.921","5.462"
"Oregon","1986","180467","14356","-968","-0.536","29.867","1753","10.578","1616","9.751","16641","1170","1199","5713","10978","15972","26950","14.933","6.083","19484","27918","8434","15.47","4.673"
"Oregon","1987","182604","14348","-3157","-1.729","31.711","1896","11.496","1621","9.829","16630","1097","1112","5717","11450","17503","28953","15.856","6.27","22711","32110","9399","17.585","5.147"
"Oregon","1988","184088","14665","6055","3.289","26.348","1905","11.336","1464","8.711","17026","974","988","4505","12038","18269","30307","16.463","6.539","15640","24252","8612","13.174","4.678"
"Oregon","1989","188829","14726","5008","2.652","25.661","1756","10.324","1447","8.507","17164","1049","1057","4732","11738","17498","29236","15.483","6.216","15920","24228","8308","12.831","4.4"
"Oregon","1990","193471","14746","6430","3.324","22.306","1662","9.72","1429","8.357","17215","1066","1079","4649","8561","19447","28008","14.477","4.425","14171","21578","7407","11.153","3.828"
"Oregon","1991","198035","14631","5935","2.997","25.871","1768","10.315","1496","8.728","17276","1061","1081","5102","13022","18530","31552","15.933","6.576","17835","25617","7782","12.936","3.93"
"Oregon","1992","204046","14613","6369","3.121","24.43","1690","9.82","1418","8.239","17346","940","950","4068","10012","21281","31293","15.336","4.907","17087","24924","7837","12.215","3.841"
"Oregon","1993","210975","14871","8514","4.036","22.032","1696","9.721","1377","7.893","17606","923","934","4265","10233","21522","31755","15.052","4.85","16279","23241","6962","11.016","3.3"
"Oregon","1994","219360","15143","6555","2.988","23.029","1689","9.504","1349","7.591","17942","967","990","4793","10310","21503","31813","14.503","4.7","17273","25258","7985","11.514","3.64"
"Oregon","1995","226437","15389","10016","4.423","22.208","1673","9.268","1338","7.412","18219","934","946","4987","11596","23563","35159","15.527","5.121","15925","25143","9218","11.104","4.071"
"Oregon","1996","230804","15448","2501","1.084","25.754","1618","8.89","1435","7.885","18291","990","1012","5034","10142","22080","32222","13.961","4.394","19988","29721","9733","12.877","4.217"
"Oregon","1997","236581","15312","8968","3.791","25.453","1637","9.002","1732","9.524","18138","1170","1200","7516","12203","26873","39076","16.517","5.158","18591","30108","11517","12.726","4.868"
"Oregon","1998","247238","15438","7649","3.094","24.296","1645","9.038","1506","8.274","18271","996","1028","5314","12406","25278","37684","15.242","5.018","18838","30035","11197","12.148","4.529"
"Oregon","1999","251722","15380","-250","-0.099","25.391","1479","8.095","1406","7.696","18306","972","991","5440","11748","20209","31957","12.695","4.667","22483","32207","9724","12.795","3.863"
"Oregon","2000","253622","15251","3413","1.346","22.824","1417","7.77","1493","8.187","18199","1065","1096","5969","9177","23179","32356","12.758","3.618","19402","28943","9541","11.412","3.762"
"Oregon","2001","255999","15180","2860","1.117","23.135","1525","8.379","1487","8.17","18220","999","1015","5391","12315","20158","32473","12.685","4.811","21142","29613","8471","11.568","3.309"
"Oregon","2002","257155","15039","-3557","-1.383","28.524","1663","9.123","1624","8.909","18248","993","1013","7171","16273","20402","36675","14.262","6.328","26912","40232","13320","15.645","5.18"
"Oregon","2003","257878","15095","6346","2.461","22.421","1482","8.125","1392","7.631","18286","844","849","4630","9590","25665","35255","13.671","3.719","19721","28909","9188","11.21","3.563"
"Oregon","2004","262641","15355","3285","1.251","23.044","1630","8.858","1314","7.141","18559","848","854","4532","10406","23140","33546","12.773","3.962","17179","30261","13082","11.522","4.981"
"Oregon","2005","268269","15557","8085","3.014","19.92","1745","9.331","1421","7.599","18863","953","964","4410","10954","23851","34805","12.974","4.083","19322","26720","7398","9.96","2.758"
"Oregon","2006","276803","15646","9115","3.293","22.039","2072","10.94","1709","9.023","19121","1207","1220","5828","14186","25431","39617","14.312","5.125","20143","30502","10359","11.019","3.742"
"Oregon","2007","285942","15796","9682","3.386","23.943","1865","9.703","1534","7.981","19386","934","960","5196","14872","29042","43914","15.358","5.201","25297","34232","8935","11.972","3.125"
"Oregon","2008","294032","15864","7768","2.642","22.313","1654","8.532","1509","7.784","19459","946","961","6270","12392","28179","40571","13.798","4.215","23348","32803","9455","11.156","3.216"
"Oregon","2009","295934","15873","-4119","-1.392","22.49","1537","7.895","1543","7.925","19466","973","986","5349","9519","23759","33278","11.245","3.217","27539","37397","9858","12.637","3.331"
"Oregon","2010","294925","16061","2645","0.897","21.792","1623","8.291","1323","6.758","19726","795","806","3380","10334","24446","34780","11.793","3.504","24012","32135","8123","10.896","2.754"
"Oregon","2011","303971","16339","11534","3.794","20.275","1916","9.618","1418","7.118","20169","888","904","4374","12099","30250","42349","13.932","3.98","23356","30815","7459","10.137","2.454"
"Oregon","2012","321492","17013","23368","7.269","19.882","2276","11.078","1444","7.028","20962","941","957","5547","16073","39254","55327","17.209","5.0","22315","31959","9644","9.941","3.0"
"Oregon","2013","337825","17387","10499","3.108","24.654","2272","10.711","1644","7.751","21525","1092","1095","7015","18153","33990","52143","15.435","5.373","26726","41644","14918","12.327","4.416"
"Oregon","2014","351426","17764","17274","4.915","20.864","2269","10.408","1622","7.441","22123","1132","1140","5225","18512","35422","53934","15.347","5.268","26327","36660","10333","10.432","2.94"
"Oregon","2015","362612","17998","5549","1.53","22.555","2231","9.998","1762","7.897","22548","1239","1261","6615","17503","28940","46443","12.808","4.827","30748","40894","10146","11.278","2.798"
"Oregon","2016","356714","17793","-18427","-5.166","19.224","1901","8.441","1877","8.334","22534","1362","1386","6699","12340","21947","34287","9.612","3.459","42130","52714","10584","14.778","2.967"
"Oregon","2017","344863","17561","-3979","-1.154","25.075","1798","8.033","2006","8.963","22278","1348","1368","6873","14492","28746","43238","12.538","4.202","32897","47217","14320","13.692","4.152"
"Oregon","2018","342997","17454","5035","1.468","21.719","1682","7.581","1761","7.937","22149","1291","1352","6512","11661","30622","42283","12.328","3.4","26333","37248","10915","10.86","3.182"
"Pennsylvania","1978","3495119","155650","185862","5.318","26.269","24569","12.914","19514","10.257","192772","12264","12466","63006","200194","444738","644932","18.452","5.728","270414","459070","188656","13.135","5.398"
"Pennsylvania","1979","3651301","158386","156793","4.294","24.314","23244","11.989","17916","9.241","196543","11125","11351","61212","207074","393603","600677","16.451","5.671","273110","443884","170774","12.157","4.677"
"Pennsylvania","1980","3703090","156963","-88129","-2.38","26.754","20537","10.496","19504","9.968","196180","12844","13043","68387","190754","304614","495368","13.377","5.151","421253","583497","162244","15.757","4.381"
"Pennsylvania","1981","3605764","157167","-95234","-2.641","24.387","20400","10.416","17944","9.162","197078","11248","11521","54212","176697","262963","439660","12.193","4.9","387963","534894","146931","14.834","4.075"
"Pennsylvania","1982","3526942","155359","-54484","-1.545","28.598","21705","11.089","20886","10.671","196138","13653","13948","69206","222151","282172","504323","14.299","6.299","406151","558807","152656","15.844","4.328"
"Pennsylvania","1983","3419299","158190","-46227","-1.352","29.122","21862","11.153","16558","8.447","198678","10431","10735","60301","194110","303766","497876","14.561","5.677","402463","544103","141640","15.913","4.142"
"Pennsylvania","1984","3470223","163251","203387","5.861","22.021","23738","11.862","15815","7.903","204078","10721","10960","54932","184225","401243","585468","16.871","5.309","264173","382081","117908","11.01","3.398"
"Pennsylvania","1985","3611521","164224","156271","4.327","24.785","22970","11.339","18765","9.264","204671","12835","13141","80528","193086","410750","603836","16.72","5.346","282282","447565","165283","12.393","4.577"
"Pennsylvania","1986","3712733","165928","109181","2.941","26.576","23811","11.649","17787","8.702","207417","12044","12282","72871","217795","384736","602531","16.229","5.866","339663","493350","153687","13.288","4.139"
"Pennsylvania","1987","3855536","168499","91056","2.362","30.369","26195","12.577","18826","9.039","211959","12343","12581","84990","259086","417423","676509","17.546","6.72","377553","585453","207900","15.185","5.392"
"Pennsylvania","1988","3952737","173412","142801","3.613","27.952","26418","12.264","18790","8.723","219231","12416","12874","94781","279426","415800","695226","17.588","7.069","360988","552425","191437","13.976","4.843"
"Pennsylvania","1989","4095416","176491","151900","3.709","26.693","25934","11.766","18960","8.602","223908","12850","13380","90055","263487","434998","698485","17.055","6.434","342761","546585","203824","13.346","4.977"
"Pennsylvania","1990","4231280","178264","94179","2.226","24.71","24164","10.769","18888","8.418","227015","13436","13817","91408","213631","403313","616944","14.581","5.049","366005","522765","156760","12.355","3.705"
"Pennsylvania","1991","4197087","177596","-124826","-2.974","25.789","23932","10.562","20076","8.861","228506","13945","14253","118877","204083","337112","541195","12.895","4.862","465046","666021","200975","15.869","4.788"
"Pennsylvania","1992","4130305","177531","23469","0.568","27.336","22382","9.841","19952","8.773","228640","12738","13131","90352","199924","388073","587997","14.236","4.84","393763","564528","170765","13.668","4.134"
"Pennsylvania","1993","4168801","180372","59961","1.438","26.169","22485","9.808","19925","8.692","230525","12478","12996","81393","193916","411514","605430","14.523","4.652","369777","545469","175692","13.085","4.214"
"Pennsylvania","1994","4280750","183558","121368","2.835","24.222","23515","10.106","19346","8.315","234761","12790","13207","85655","213644","426167","639811","14.946","4.991","345321","518443","173122","12.111","4.044"
"Pennsylvania","1995","4419850","187257","173878","3.934","22.772","24760","10.452","19427","8.201","239559","12963","13425","85310","229595","447527","677122","15.32","5.195","341451","503244","161793","11.386","3.661"
"Pennsylvania","1996","4504477","187845","64826","1.439","25.904","23790","9.93","20476","8.547","241227","13694","14110","92258","224301","423945","648246","14.391","4.98","398352","583420","185068","12.952","4.109"
"Pennsylvania","1997","4587244","188711","71537","1.559","28.58","25128","10.399","23274","9.632","242562","14524","15029","100257","264615","462437","727052","15.849","5.768","429539","655515","225976","14.29","4.926"
"Pennsylvania","1998","4728122","190385","118425","2.505","25.586","23095","9.471","20803","8.531","244988","13067","13540","86399","230181","493112","723293","15.298","4.868","391311","604868","213557","12.793","4.517"
"Pennsylvania","1999","4812291","190047","27705","0.576","27.293","21969","8.969","20619","8.418","245623","13154","13716","92638","225340","459073","684413","14.222","4.683","435783","656708","220925","13.646","4.591"
"Pennsylvania","2000","4911169","189615","109202","2.224","26.768","22106","9.001","21083","8.585","246102","12965","13498","89768","250759","515742","766501","15.607","5.106","427997","657299","229302","13.384","4.669"
"Pennsylvania","2001","4932995","188039","-66824","-1.355","26.398","21895","8.923","21516","8.769","245566","13153","13738","91295","236793","414312","651105","13.199","4.8","512508","717929","205421","14.554","4.164"
"Pennsylvania","2002","4821039","186768","-188456","-3.909","29.313","24279","9.894","24269","9.89","245389","13987","14552","129737","268605","437979","706584","14.656","5.572","612312","895040","282728","18.565","5.864"
"Pennsylvania","2003","4733895","186517","11000","0.232","27.822","22528","9.196","22158","9.045","245173","13003","13429","85874","210960","458574","669534","14.143","4.456","459060","658534","199474","13.911","4.214"
"Pennsylvania","2004","4730211","187016","-16611","-0.351","25.824","22312","9.089","20924","8.523","246189","12881","13412","97152","196797","413979","610776","12.912","4.16","407591","627387","219796","13.263","4.647"
"Pennsylvania","2005","4727046","186732","14951","0.316","26.644","22505","9.14","21426","8.701","246777","13612","13950","92283","223734","420954","644688","13.638","4.733","440991","629737","188746","13.322","3.993"
"Pennsylvania","2006","4764041","186244","62338","1.309","25.112","24841","10.045","22363","9.043","248543","14718","15081","89590","234599","425918","660517","13.865","4.924","402581","598179","195598","12.556","4.106"
"Pennsylvania","2007","4772249","183773","-46499","-0.974","26.39","23283","9.402","23664","9.556","247436","14328","14657","92551","222508","407184","629692","13.195","4.663","457498","676191","218693","14.169","4.583"
"Pennsylvania","2008","4724054","179508","-45305","-0.959","25.431","19674","8.04","23984","9.801","242546","14691","15049","104252","196186","404502","600688","12.716","4.153","427232","645993","218761","13.675","4.631"
"Pennsylvania","2009","4581859","174023","-256952","-5.608","20.954","17598","7.34","23859","9.952","236619","14561","15032","98613","178702","301332","480034","10.477","3.9","536183","736986","200803","16.085","4.383"
"Pennsylvania","2010","4396663","170312","-109018","-2.48","20.886","17371","7.409","20750","8.851","232756","12043","12500","74820","142922","316230","459152","10.443","3.251","420697","568170","147473","12.923","3.354"
"Pennsylvania","2011","4383991","168717","74130","1.691","21.294","18070","7.8","19192","8.284","231111","11390","11918","70521","141205","399699","540904","12.338","3.221","324699","466774","142075","10.647","3.241"
"Pennsylvania","2012","4469116","168788","104933","2.348","21.603","18786","8.141","18222","7.896","231045","10429","10836","70955","153157","434514","587671","13.15","3.427","332497","482738","150241","10.802","3.362"
"Pennsylvania","2013","4534028","167628","28068","0.619","22.714","18034","7.828","18164","7.885","230311","10710","10967","65789","153485","389506","542991","11.976","3.385","343966","514923","170957","11.357","3.771"
"Pennsylvania","2014","4578303","166901","58468","1.277","20.311","17918","7.775","16804","7.292","231005","10339","10653","62617","158250","365165","523415","11.433","3.457","340019","464947","124928","10.155","2.729"
"Pennsylvania","2015","4645855","166737","76093","1.638","20.871","19092","8.244","17094","7.382","232575","10312","10616","71023","171112","389800","560912","12.073","3.683","345251","484819","139568","10.436","3.004"
"Pennsylvania","2016","4732835","166882","84809","1.792","19.608","19499","8.328","15611","6.667","236083","10474","10823","68900","164565","384245","548810","11.596","3.477","339646","464001","124355","9.804","2.627"
"Pennsylvania","2017","4780939","165592","34712","0.726","23.309","17630","7.522","20090","8.572","233141","11064","11467","97139","169252","422666","591918","12.381","3.54","365007","557206","192199","11.655","4.02"
"Pennsylvania","2018","4832277","165006","67048","1.388","20.683","16383","7.05","16949","7.293","232107","11308","11872","77577","156135","410654","566789","11.729","3.231","353178","499741","146563","10.342","3.033"
"Rhode Island","1978","759066","52035","64444","8.49","31.972","10057","16.98","7864","13.278","60324","5679","5732","28175","76285","109504","185789","24.476","10.05","67663","121345","53682","15.986","7.072"
"Rhode Island","1979","821120","53516","60582","7.378","29.578","9940","16.328","7241","11.894","62228","5180","5222","28590","69139","112878","182017","22.167","8.42","72613","121435","48822","14.789","5.946"
"Rhode Island","1980","866470","54086","32391","3.738","33.808","9500","15.213","7822","12.526","63285","5678","5755","32270","75358","103502","178860","20.642","8.697","91511","146469","54958","16.904","6.343"
"Rhode Island","1981","907693","55854","56991","6.279","28.853","9959","15.527","7140","11.132","65548","4986","5072","24619","73807","114131","187938","20.705","8.131","88132","130947","42815","14.426","4.717"
"Rhode Island","1982","963203","57624","58832","6.108","33.955","11030","16.623","8227","12.398","67757","6024","6098","32702","88209","134151","222360","23.085","9.158","102157","163528","61371","16.978","6.372"
"Rhode Island","1983","953024","58993","-59742","-6.269","34.744","10157","14.965","7631","11.244","69133","5662","5742","36830","70219","95341","165560","17.372","7.368","164214","225302","61088","23.641","6.41"
"Rhode Island","1984","925768","60660","20797","2.246","34.109","11083","15.918","8056","11.57","71139","6204","6279","33769","73928","104752","178680","19.301","7.986","104618","157883","53265","17.054","5.754"
"Rhode Island","1985","947027","59818","53849","5.686","33.267","10028","14.313","9422","13.448","70363","7178","7245","39844","96240","115134","211374","22.32","10.162","96920","157525","60605","16.634","6.4"
"Rhode Island","1986","958132","57770","-18232","-1.903","33.51","9177","13.337","9463","13.752","68667","7089","7192","37306","70662","89873","160535","16.755","7.375","114361","178767","64406","18.658","6.722"
"Rhode Island","1987","910196","55433","-93300","-10.251","34.121","8739","13.075","9657","14.449","66377","6678","6820","38499","73418","81867","155285","17.061","8.066","179903","248585","68682","27.311","7.546"
"Rhode Island","1988","877309","55534","24590","2.803","33.631","8854","13.297","8058","12.101","66985","5723","5888","31113","68207","103908","172115","19.619","7.775","90369","147525","57156","16.816","6.515"
"Rhode Island","1989","901552","55680","34311","3.806","29.692","8621","12.929","7319","10.976","67331","5291","5401","29202","63959","104197","168156","18.652","7.094","83047","133845","50798","14.846","5.635"
"Rhode Island","1990","925777","56358","23425","2.53","28.92","8423","12.521","6817","10.133","68076","4963","5085","27383","56732","100558","157290","16.99","6.128","87210","133865","46655","14.46","5.04"
"Rhode Island","1991","942758","56816","23216","2.463","29.157","8731","12.806","6800","9.974","69142","4844","4971","31062","67471","93184","160655","17.041","7.157","86550","137439","50889","14.578","5.398"
"Rhode Island","1992","955603","57148","12908","1.351","31.029","8270","11.997","6793","9.854","69673","4706","4813","28227","56600","104565","161165","16.865","5.923","96522","148257","51735","15.515","5.414"
"Rhode Island","1993","970975","58515","17235","1.775","29.393","8242","11.748","6840","9.75","70856","4597","4680","27556","54909","105024","159933","16.471","5.655","93161","142698","49537","14.696","5.102"
"Rhode Island","1994","994781","59780","26323","2.646","27.71","8667","12.098","6938","9.684","72505","4939","5025","29991","59852","104296","164148","16.501","6.017","87182","137825","50643","13.855","5.091"
"Rhode Island","1995","1022004","60747","30215","2.956","26.71","8507","11.655","7050","9.659","73720","5104","5232","30031","61291","105415","166706","16.312","5.997","85399","136491","51092","13.355","4.999"
"Rhode Island","1996","1041845","61172","24730","2.374","27.857","8618","11.668","7240","9.803","74546","5276","5386","30186","67383","102462","169845","16.302","6.468","90736","145115","54379","13.929","5.219"
"Rhode Island","1997","1076382","61696","41438","3.85","29.628","9193","12.281","8021","10.715","75443","5515","5646","33348","73162","127729","200891","18.664","6.797","104584","159453","54869","14.814","5.098"
"Rhode Island","1998","1130468","62404","40025","3.541","27.74","8547","11.258","7657","10.085","76367","5093","5265","32678","67412","129410","196822","17.411","5.963","93886","156797","62911","13.87","5.565"
"Rhode Island","1999","1152642","62257","1439","0.125","32.252","8460","11.081","8000","10.478","76578","5333","5498","34620","70068","117248","187316","16.251","6.079","116643","185877","69234","16.126","6.007"
"Rhode Island","2000","1177783","61984","40906","3.473","28.237","8168","10.684","7909","10.345","76583","5138","5304","30832","75561","131630","207191","17.592","6.416","104248","166285","62037","14.118","5.267"
"Rhode Island","2001","1204492","61806","8198","0.681","30.203","8187","10.695","7765","10.143","76764","4991","5117","30534","70156","119936","190092","15.782","5.825","115987","181894","65907","15.101","5.472"
"Rhode Island","2002","1199940","62346","-23812","-1.984","33.938","8898","11.535","8059","10.447","77558","4934","5090","39874","80166","123453","203619","16.969","6.681","142863","227431","84568","18.954","7.048"
"Rhode Island","2003","1179523","62697","-15959","-1.353","29.612","8133","10.473","7373","9.494","78040","4870","4922","28737","57803","116837","174640","14.806","4.901","132242","190599","58357","16.159","4.948"
"Rhode Island","2004","1178095","63476","13226","1.123","27.887","8166","10.412","7020","8.951","79004","4591","4703","26923","58756","118737","177493","15.066","4.987","110500","164267","53767","13.943","4.564"
"Rhode Island","2005","1199100","64311","26553","2.214","25.924","8843","11.111","7333","9.213","80346","4976","5077","30099","68997","112986","181983","15.177","5.754","104307","155430","51123","12.962","4.263"
"Rhode Island","2006","1244687","65208","63087","5.069","24.516","9930","12.261","8081","9.978","81913","5675","5824","30953","84887","130772","215659","17.326","6.82","98303","152572","54269","12.258","4.36"
"Rhode Island","2007","1285945","65764","21090","1.64","29.453","9243","11.223","7682","9.327","83140","5001","5079","30150","68744","141719","210463","16.366","5.346","130557","189373","58816","14.726","4.574"
"Rhode Island","2008","1309379","65920","23225","1.774","26.859","8572","10.284","7696","9.233","83788","5150","5277","27637","67276","131790","199066","15.203","5.138","121040","175841","54801","13.429","4.185"
"Rhode Island","2009","1302606","65673","-40661","-3.122","24.243","7514","8.971","7845","9.366","83597","5238","5340","36792","53797","104096","157893","12.121","4.13","135058","198554","63496","15.243","4.875"
"Rhode Island","2010","1258350","64939","-45287","-3.599","21.999","7006","8.425","7365","8.856","82980","4772","4841","25588","53271","85143","138414","11.0","4.233","132394","183701","51307","14.599","4.077"
"Rhode Island","2011","1248701","64638","27011","2.163","22.01","7425","8.959","7094","8.559","83046","4753","4911","22755","47986","116445","164431","13.168","3.843","96296","137420","41124","11.005","3.293"
"Rhode Island","2012","1278071","65155","31409","2.458","23.453","7766","9.33","6794","8.162","83722","4252","4380","23603","57981","123301","181282","14.184","4.537","103115","149873","46758","11.727","3.658"
"Rhode Island","2013","1305586","65521","26158","2.004","22.884","7614","9.082","6827","8.143","84232","4335","4451","27099","56957","118584","175541","13.445","4.363","99096","149383","50287","11.442","3.852"
"Rhode Island","2014","1335147","65874","35776","2.68","21.422","7602","8.991","6624","7.835","85037","4504","4569","26887","55335","123449","178784","13.391","4.144","95806","143008","47202","10.711","3.535"
"Rhode Island","2015","1359033","65931","13909","1.023","23.31","7775","9.125","6960","8.168","85614","4725","4813","25556","58569","113736","172305","12.679","4.31","106005","158396","52391","11.655","3.855"
"Rhode Island","2016","1361338","65650","-9953","-0.731","24.088","7900","9.209","7186","8.377","86143","5043","5134","26404","57419","106542","163961","12.044","4.218","127864","173914","46050","12.775","3.383"
"Rhode Island","2017","1353617","65400","5845","0.432","24.839","7421","8.65","7625","8.887","85693","4907","5020","29633","56373","117585","173958","12.851","4.165","113597","168113","54516","12.42","4.027"
"Rhode Island","2018","1369738","65386","25553","1.866","22.539","7158","8.372","7112","8.319","85518","5193","5358","27892","52329","127585","179914","13.135","3.82","106041","154361","48320","11.269","3.528"
"South Carolina","1978","727763","50075","107475","14.768","25.987","10652","19.121","6569","11.792","57750","4670","4697","23383","71170","130867","202037","27.761","9.779","51486","94562","43076","12.994","5.919"
"South Carolina","1979","801544","51855","41997","5.24","31.656","9866","16.862","6929","11.842","59979","4739","4799","24791","64216","104650","168866","21.068","8.012","75015","126869","51854","15.828","6.469"
"South Carolina","1980","828869","52306","8891","1.073","35.751","9472","15.786","8219","13.698","60629","5754","5875","30845","68914","88140","157054","18.948","8.314","95522","148163","52641","17.875","6.351"
"South Carolina","1981","818716","52748","-21984","-2.685","31.843","8716","14.377","7281","12.01","61344","4991","5078","23467","55184","75167","130351","15.921","6.74","106254","152335","46081","18.607","5.628"
"South Carolina","1982","786419","51093","-37870","-4.816","32.131","8761","14.521","8981","14.886","60222","6406","6498","28771","58788","67556","126344","16.066","7.475","117866","164214","46348","20.881","5.894"
"South Carolina","1983","763682","51739","7701","1.008","35.46","8348","13.928","6491","10.829","60867","4427","4546","23834","58997","84103","143100","18.738","7.725","96025","135399","39374","17.73","5.156"
"South Carolina","1984","786499","54342","52669","6.697","27.506","9767","15.812","5926","9.594","63690","4316","4381","19688","54993","105843","160836","20.45","6.992","75407","108167","32760","13.753","4.165"
"South Carolina","1985","820143","54941","30870","3.764","32.314","9361","14.786","7555","11.934","64211","5426","5593","29752","62718","100661","163379","19.921","7.647","82471","132509","50038","16.157","6.101"
"South Carolina","1986","838217","55906","21359","2.548","32.466","9510","14.833","7009","10.932","65363","5041","5100","27852","62770","94657","157427","18.781","7.489","88282","136068","47786","16.233","5.701"
"South Carolina","1987","878528","56911","12741","1.45","36.776","10161","15.479","7537","11.482","66956","5332","5385","32012","66983","107303","174286","19.838","7.624","105242","161545","56303","18.388","6.409"
"South Carolina","1988","909086","58596","46458","5.11","31.466","9866","14.508","7397","10.878","69237","5216","5342","32832","71466","118017","189483","20.843","7.861","84386","143025","58639","15.733","6.45"
"South Carolina","1989","952393","60131","51711","5.43","29.926","9896","14.178","6953","9.962","71268","5054","5184","29664","69419","124799","194218","20.393","7.289","84135","142507","58372","14.963","6.129"
"South Carolina","1990","995009","61282","47649","4.789","28.017","9505","13.285","7229","10.104","72684","5236","5366","31504","65814","121222","187036","18.797","6.614","90496","139387","48891","14.009","4.914"
"South Carolina","1991","1015668","61736","4611","0.454","33.893","10001","13.722","7595","10.421","74086","5387","5572","38093","72793","103938","176731","17.4","7.167","110797","172120","61323","16.946","6.038"
"South Carolina","1992","1024348","62823","25934","2.532","30.702","9463","12.754","7161","9.652","75345","4827","4913","28505","66763","116421","183184","17.883","6.518","107577","157250","49673","15.351","4.849"
"South Carolina","1993","1046253","64454","21943","2.097","29.939","9405","12.39","7592","10.002","76812","4914","4995","24580","56486","122075","178561","17.067","5.399","104810","156618","51808","14.969","4.952"
"South Carolina","1994","1091387","67341","51738","4.741","26.626","10810","13.772","7290","9.287","80255","5078","5186","29212","70768","126266","197034","18.054","6.484","96037","145296","49259","13.313","4.513"
"South Carolina","1995","1143260","69425","57491","5.029","25.805","10875","13.365","7954","9.775","82828","5604","5779","34017","73001","132001","205002","17.931","6.385","95534","147511","51977","12.903","4.546"
"South Carolina","1996","1187263","70752","49927","4.205","26.537","10703","12.834","8260","9.905","84617","5864","5994","33610","71341","136119","207460","17.474","6.009","104429","157533","53104","13.269","4.473"
"South Carolina","1997","1246802","71890","49586","3.977","29.953","11059","12.981","9352","10.977","86050","6239","6343","34404","79295","157019","236314","18.954","6.36","118503","186728","68225","14.977","5.472"
"South Carolina","1998","1290824","73083","27556","2.135","29.301","10544","12.16","9111","10.507","87428","5897","6006","33091","79596","137071","216667","16.785","6.166","121728","189111","67383","14.65","5.22"
"South Carolina","1999","1310225","73505","19234","1.468","29.572","10433","11.893","9100","10.374","88388","6121","6304","37498","74456","138511","212967","16.254","5.683","117020","193733","76713","14.786","5.855"
"South Carolina","2000","1333413","73678","17726","1.329","30.534","9930","11.239","9273","10.495","88685","6006","6211","33731","83091","138205","221296","16.596","6.231","132152","203570","71418","15.267","5.356"
"South Carolina","2001","1353070","73878","13831","1.022","30.122","10572","11.894","9258","10.416","89540","6023","6201","31927","82847","134772","217619","16.083","6.123","142350","203788","61438","15.061","4.541"
"South Carolina","2002","1344678","73545","-40322","-2.999","31.485","10651","11.89","10131","11.31","89838","6245","6403","45354","80776","130909","211685","15.742","6.007","168579","252007","83428","18.741","6.204"
"South Carolina","2003","1325108","74896","7781","0.587","29.653","10722","11.862","8887","9.832","91307","5479","5574","28640","62244","142003","204247","15.414","4.697","128646","196466","67820","14.826","5.118"
"South Carolina","2004","1338512","76235","16808","1.256","25.779","10591","11.512","8681","9.436","92952","5608","5708","30878","65572","123761","189333","14.145","4.899","109352","172525","63173","12.889","4.72"
"South Carolina","2005","1373757","78744","50529","3.678","23.659","11962","12.686","8819","9.353","95865","5679","5831","29056","77105","135934","213039","15.508","5.613","107581","162510","54929","11.83","3.998"
"South Carolina","2006","1426797","81130","56678","3.972","24.45","13582","13.95","9820","10.086","99246","7155","7210","35411","87012","144090","231102","16.197","6.098","118757","174424","55667","12.225","3.902"
"South Carolina","2007","1468883","82668","17334","1.18","27.1","12076","12.062","9431","9.42","101435","6166","6267","31040","71993","144377","216370","14.73","4.901","137974","199036","61062","13.55","4.157"
"South Carolina","2008","1475520","82135","-444","-0.03","26.862","10598","10.482","10506","10.391","101152","7020","7133","32956","61163","137014","198177","13.431","4.145","137709","198621","60912","13.461","4.128"
"South Carolina","2009","1416986","78708","-108126","-7.631","21.63","8803","8.852","12095","12.163","97799","7891","8014","39294","56774","96471","153245","10.815","4.007","194018","261371","67353","18.446","4.753"
"South Carolina","2010","1336991","77467","-27401","-2.049","22.826","9521","9.803","10156","10.456","96809","6301","6439","27405","53083","99508","152591","11.413","3.97","128706","179992","51286","13.462","3.836"
"South Carolina","2011","1330990","77060","16121","1.211","22.671","9447","9.79","9414","9.756","96512","5957","6155","25831","46435","120562","166997","12.547","3.489","102052","150876","48824","11.336","3.668"
"South Carolina","2012","1351680","77586","27874","2.062","22.102","9583","9.931","8877","9.199","96848","5181","5271","23430","52799","124447","177246","13.113","3.906","104331","149372","45041","11.051","3.332"
"South Carolina","2013","1374634","78384","33361","2.427","20.993","9744","10.028","8356","8.599","97863","5137","5221","23863","49320","128327","177647","12.923","3.588","97476","144286","46810","10.496","3.405"
"South Carolina","2014","1412546","79418","42599","3.016","20.196","9856","10.006","8038","8.16","99411","5250","5321","22588","56065","129171","185236","13.114","3.969","100283","142637","42354","10.098","2.998"
"South Carolina","2015","1465098","80993","60304","4.116","19.498","10282","10.241","7739","7.708","101675","5060","5121","24928","63348","139792","203140","13.865","4.324","98051","142836","44785","9.749","3.057"
"South Carolina","2016","1521368","82776","50686","3.332","19.101","10563","10.283","7970","7.759","104019","5401","5499","25957","59522","136466","195988","12.882","3.912","99164","145302","46138","9.551","3.033"
"South Carolina","2017","1568705","83824","47410","3.022","21.669","10481","10.02","8675","8.293","105504","5916","6009","27729","61209","156159","217368","13.857","3.902","117238","169958","52720","10.834","3.361"
"South Carolina","2018","1611137","85235","34942","2.169","20.575","10214","9.634","8640","8.149","106812","6429","6555","32462","58018","142672","200690","12.456","3.601","112415","165748","53333","10.288","3.31"
"South Dakota","1978","3751970","177656","136249","3.631","29.445","25591","12.215","21148","10.094","211727","13480","13732","106309","224170","464460","688630","18.354","5.975","306318","552381","246063","14.722","6.558"
"South Dakota","1979","3869635","181634","166116","4.293","24.264","24469","11.448","18022","8.432","216966","12164","12347","63461","205446","430142","635588","16.425","5.309","308086","469472","161386","12.132","4.171"
"South Dakota","1980","3951598","179229","648","0.016","27.826","21298","9.892","22057","10.245","214915","14534","14754","77531","203421","347003","550424","13.929","5.148","365110","549776","184666","13.913","4.673"
"South Dakota","1981","3924989","177722","-35722","-0.91","25.638","20419","9.541","19242","8.991","214611","12450","12718","62672","195416","307738","503154","12.819","4.979","392652","538876","146224","13.729","3.725"
"South Dakota","1982","3914479","175993","27722","0.708","29.094","22756","10.646","21181","9.909","214545","14157","14461","75090","259464","337689","597153","15.255","6.628","406369","569431","163062","14.547","4.166"
"South Dakota","1983","3843021","180112","-62928","-1.637","29.06","23910","11.11","17057","7.925","218644","11000","11303","66766","210231","348163","558394","14.53","5.47","460873","621322","160449","16.168","4.175"
"South Dakota","1984","3893427","184384","202192","5.193","23.368","25729","11.708","18278","8.317","223489","12375","12605","66186","229766","427339","657105","16.877","5.901","318423","454913","136490","11.684","3.506"
"South Dakota","1985","4010534","186031","104570","2.607","26.517","26467","11.885","21314","9.571","225263","14453","14814","100137","220782","415526","636308","15.866","5.505","339576","531738","192162","13.259","4.791"
"South Dakota","1986","4077513","190419","114087","2.798","27.435","27983","12.365","19459","8.598","230569","13307","13603","82267","252323","421090","673413","16.515","6.188","388444","559326","170882","13.717","4.191"
"South Dakota","1987","4191685","194764","134560","3.21","28.238","29632","12.761","20808","8.961","236616","13986","14241","95934","269246","457145","726391","17.329","6.423","386355","591831","205476","14.119","4.902"
"South Dakota","1988","4317319","201490","121477","2.814","28.137","30028","12.46","20692","8.586","245667","14357","14720","111006","265726","463136","728862","16.882","6.155","398776","607385","208609","14.069","4.832"
"South Dakota","1989","4431444","206026","134326","3.031","25.801","29125","11.762","20878","8.431","251751","14670","15096","100491","245702","460312","706014","15.932","5.545","370085","571688","201603","12.901","4.549"
"South Dakota","1990","4548670","209364","109206","2.401","24.22","27632","10.918","20843","8.235","256488","15133","15520","95191","213128","446922","660050","14.511","4.686","392185","550844","158659","12.11","3.488"
"South Dakota","1991","4540075","207718","-72346","-1.593","26.659","26164","10.243","23043","9.021","256992","16363","16862","126867","227228","377941","605169","13.329","5.005","465846","677515","211669","14.923","4.662"
"South Dakota","1992","4503357","205910","-10989","-0.244","28.467","24025","9.422","22863","8.967","255561","15235","15626","92551","224845","416141","640986","14.234","4.993","471398","651975","180577","14.478","4.01"
"South Dakota","1993","4507598","206305","20722","0.46","26.967","23208","9.099","22804","8.94","255274","14929","15353","91097","204444","424055","628499","13.943","4.536","417838","607777","189939","13.483","4.214"
"South Dakota","1994","4541395","206275","15787","0.348","27.237","23700","9.264","22315","8.722","256530","15213","15606","123439","218138","416124","634262","13.966","4.803","393335","618475","225140","13.619","4.958"
"South Dakota","1995","4606755","209259","123987","2.691","23.238","25744","9.968","21030","8.143","260616","14291","14810","109109","233759","425491","659250","14.311","5.074","342690","535263","192573","11.619","4.18"
"South Dakota","1996","4630009","208807","33700","0.728","25.611","24673","9.488","22360","8.598","261208","15190","15640","98443","225653","400934","626587","13.533","4.874","392510","592887","200377","12.805","4.328"
"South Dakota","1997","4706455","210156","102357","2.175","27.528","26876","10.254","23969","9.145","263558","15332","15921","119884","264965","485187","750152","15.939","5.63","411184","647795","236611","13.764","5.027"
"South Dakota","1998","4839637","212283","89246","1.844","25.591","24840","9.372","22073","8.328","266420","13800","14260","89003","228445","480052","708497","14.639","4.72","409652","619251","209599","12.795","4.331"
"South Dakota","1999","4909852","212310","52783","1.075","26.153","23983","9.003","22398","8.408","267183","14342","14798","94094","241511","453298","694809","14.151","4.919","427350","642026","214676","13.076","4.372"
"South Dakota","2000","4995545","212836","115117","2.304","25.379","24069","8.992","22221","8.302","268587","13838","14394","88136","258553","490479","749032","14.994","5.176","411942","633915","221973","12.69","4.443"
"South Dakota","2001","5057445","212418","21533","0.426","27.054","24900","9.268","22969","8.55","269621","14054","14696","100590","259709","445951","705660","13.953","5.135","456582","684127","227545","13.527","4.499"
"South Dakota","2002","5054207","212076","-97518","-1.929","29.821","26537","9.83","25488","9.441","270490","14856","15500","133510","292389","461223","753612","14.911","5.785","544679","851130","306451","16.84","6.063"
"South Dakota","2003","4983843","212612","-10579","-0.212","27.745","24949","9.217","23358","8.629","271489","14005","14456","91527","221883","469495","691378","13.872","4.452","486253","701957","215704","14.085","4.328"
"South Dakota","2004","5012015","215028","58422","1.166","24.419","25156","9.229","22195","8.143","274046","13813","14116","84843","204800","465576","670376","13.375","4.086","410187","611954","201767","12.21","4.026"
"South Dakota","2005","5063334","216422","2909","0.057","25.274","26501","9.636","23413","8.513","276565","14924","15291","85784","231805","410954","642759","12.694","4.578","449233","639850","190617","12.637","3.765"
"South Dakota","2006","5121671","216702","113306","2.212","22.485","28084","10.112","23914","8.611","279813","16123","16571","91932","246827","442295","689122","13.455","4.819","396840","575816","178976","11.243","3.494"
"South Dakota","2007","5177329","216089","1174","0.023","26.353","26080","9.335","25268","9.044","279787","14912","15239","88680","225340","458031","683371","13.199","4.352","459158","682197","223039","13.177","4.308"
"South Dakota","2008","5186930","214096","27312","0.527","24.402","23867","8.553","24131","8.647","278931","15203","15525","83371","196765","463415","660180","12.728","3.793","437800","632868","195068","12.201","3.761"
"South Dakota","2009","5113427","211081","-188725","-3.691","20.525","21463","7.73","24845","8.948","275969","14984","15393","105431","177950","346820","524770","10.263","3.48","504337","713495","209158","13.953","4.09"
"South Dakota","2010","4987351","208159","-62779","-1.259","21.707","21049","7.669","23060","8.402","273451","13795","14165","75823","179787","361523","541310","10.854","3.605","438039","604089","166050","12.112","3.329"
"South Dakota","2011","5008678","207427","97500","1.947","20.599","22093","8.082","21167","7.743","273828","12849","13195","66609","183418","429944","613362","12.246","3.662","364758","515862","151104","10.299","3.017"
"South Dakota","2012","5098356","208322","90360","1.772","21.054","22073","8.063","20976","7.662","274313","12144","12550","74836","170006","457049","627055","12.299","3.335","372897","536695","163798","10.527","3.213"
"South Dakota","2013","5150353","207688","13706","0.266","22.312","22291","8.125","21158","7.712","274924","12689","12871","86009","180751","407529","588280","11.422","3.509","406537","574574","168037","11.156","3.263"
"South Dakota","2014","5192909","207256","70597","1.359","19.58","21904","7.969","20879","7.596","275382","12826","13143","75430","179070","399921","578991","11.15","3.448","353396","508394","154998","9.79","2.985"
"South Dakota","2015","5260089","207064","62652","1.191","20.711","22395","8.127","21022","7.628","276266","12771","13139","74041","206364","400997","607361","11.547","3.923","380280","544709","164429","10.356","3.126"
"South Dakota","2016","5316518","208431","56722","1.067","20.418","23378","8.419","19287","6.946","279717","12751","13086","77058","187929","411555","599484","11.276","3.535","381265","542762","161497","10.209","3.038"
"South Dakota","2017","5374014","207581","78060","1.453","21.132","21549","7.727","21959","7.874","278690","13685","13977","74542","179074","466817","645891","12.019","3.332","397019","567831","170812","10.566","3.178"
"South Dakota","2018","5444444","207438","58056","1.066","19.881","21171","7.597","20088","7.209","279211","13964","14348","78641","166305","432945","599250","11.007","3.055","384825","541194","156369","9.94","2.872"
"Texas","1978","311398","18069","20022","6.43","26.054","2477","12.52","1961","9.912","20043","1372","1379","8108","19161","41426","60587","19.456","6.153","22491","40565","18074","13.027","5.804"
"Texas","1979","330355","18628","16600","5.025","25.431","2403","11.843","1678","8.27","20653","1154","1168","6640","19324","39283","58607","17.741","5.849","26745","42007","15262","12.716","4.62"
"Texas","1980","338968","18317","-1698","-0.501","28.142","2130","10.42","2200","10.762","20407","1446","1456","6508","16320","31377","47697","14.071","4.815","35827","49395","13568","14.572","4.003"
"Texas","1981","336455","18561","-195","-0.058","28.615","2179","10.635","1753","8.556","20701","1093","1101","6060","17932","30207","48139","14.308","5.33","35034","48334","13300","14.366","3.953"
"Texas","1982","333887","18364","-3924","-1.175","28.28","2098","10.206","2180","10.605","20516","1502","1520","8438","17361","29850","47211","14.14","5.2","36124","51135","15011","15.315","4.496"
"Texas","1983","329431","18578","1570","0.477","26.621","2192","10.727","1693","8.285","20683","1177","1185","6316","12289","33130","45419","13.787","3.73","31469","43849","12380","13.311","3.758"
"Texas","1984","341850","19292","24542","7.179","21.585","2555","12.2","1661","7.931","21389","1181","1208","6457","18652","42784","61436","17.972","5.456","24946","36894","11948","10.792","3.495"
"Texas","1985","359189","19715","11417","3.179","27.499","2763","12.84","1984","9.22","21909","1473","1491","10511","22220","38583","60803","16.928","6.186","31925","49386","17461","13.749","4.861"
"Texas","1986","366900","20319","16127","4.395","23.985","2910","13.205","1970","8.94","22507","1401","1410","8213","20201","39926","60127","16.388","5.506","27844","44000","16156","11.992","4.403"
"Texas","1987","395342","21083","-6491","-1.642","34.948","3344","14.631","2174","9.512","23440","1597","1624","11701","26236","42845","69081","17.474","6.636","56342","75572","19230","19.116","4.864"
"Texas","1988","399133","21968","9734","2.439","29.493","3382","14.154","2370","9.918","24401","1701","1716","10336","25710","42883","68593","17.186","6.441","38167","58859","20692","14.747","5.184"
"Texas","1989","401627","22400","3233","0.805","30.732","3302","13.422","2471","10.044","25017","1932","1949","13221","25644","39302","64946","16.171","6.385","39429","61713","22284","15.366","5.548"
"Texas","1990","396727","22171","-10407","-2.623","26.918","2751","11.088","2692","10.85","24840","2084","2100","11579","21786","31609","53395","13.459","5.491","44993","63802","18809","16.082","4.741"
"Texas","1991","381465","21264","-25724","-6.743","26.574","2444","10.067","3034","12.497","23982","2169","2203","14839","22327","28358","50685","13.287","5.853","50135","76409","26274","20.03","6.888"
"Texas","1992","361638","20812","-6972","-1.928","28.018","2419","10.251","2635","11.166","23490","1759","1791","11263","17851","32810","50661","14.009","4.936","37680","57633","19953","15.937","5.517"
"Texas","1993","362305","21168","10554","2.913","24.82","2650","11.203","2232","9.436","23863","1510","1543","8306","18839","36677","55516","15.323","5.2","30164","44962","14798","12.41","4.084"
"Texas","1994","369507","21507","1723","0.466","29.547","2702","11.242","2343","9.748","24215","1651","1689","10103","23919","32394","56313","15.24","6.473","34017","54590","20573","14.774","5.568"
"Texas","1995","367433","21720","8201","2.232","24.451","2625","10.784","2274","9.342","24517","1602","1623","7627","18465","34657","53122","14.458","5.025","30614","44921","14307","12.226","3.894"
"Texas","1996","368943","21785","-488","-0.132","26.252","2588","10.565","2354","9.609","24614","1661","1671","8777","15978","32450","48428","13.126","4.331","32157","48916","16759","13.258","4.542"
"Texas","1997","380399","22025","8864","2.33","26.666","2642","10.693","2386","9.657","24836","1685","1705","9645","19997","39586","59583","15.663","5.257","33730","50719","16989","13.333","4.466"
"Texas","1998","395390","22350","14557","3.682","23.072","2488","9.951","2186","8.743","25153","1477","1490","6228","20134","40035","60169","15.218","5.092","32821","45612","12791","11.536","3.235"
"Texas","1999","407915","22251","3386","0.83","25.681","2387","9.495","2290","9.109","25189","1610","1624","7657","16937","38827","55764","13.67","4.152","36600","52378","15778","12.84","3.868"
"Texas","2000","414303","22341","5501","1.328","27.304","2457","9.723","2229","8.82","25385","1484","1523","8112","20617","41444","62061","14.98","4.976","33954","56560","22606","13.652","5.456"
"Texas","2001","414775","22318","-1699","-0.41","25.323","2391","9.43","2265","8.933","25419","1475","1515","8545","17502","35014","52516","12.661","4.22","39162","54215","15053","13.071","3.629"
"Texas","2002","415757","22218","3338","0.803","29.814","2648","10.409","2469","9.706","25528","1554","1570","9614","27527","37788","65315","15.71","6.621","43042","61977","18935","14.907","4.554"
"Texas","2003","418547","22456","4442","1.061","25.987","2660","10.386","2391","9.335","25747","1420","1465","7524","18052","40773","58825","14.055","4.313","37367","54383","17016","12.993","4.065"
"Texas","2004","428311","23066","12171","2.842","23.092","2895","11.092","2141","8.203","26478","1447","1454","7862","19111","42512","61623","14.387","4.462","33939","49452","15513","11.546","3.622"
"Texas","2005","437792","23193","4471","1.021","22.384","2750","10.345","2470","9.292","26722","1629","1637","8823","19781","33688","53469","12.213","4.518","34147","48998","14851","11.192","3.392"
"Texas","2006","439764","23506","-120","-0.027","27.76","3099","11.497","2523","9.36","27243","1712","1751","8714","22783","38256","61039","13.88","5.181","44264","61159","16895","13.907","3.842"
"Texas","2007","439831","23290","4543","1.033","25.953","2720","10.003","2706","9.952","27198","1819","1837","10924","21957","39660","61617","14.009","4.992","39252","57074","17822","12.976","4.052"
"Texas","2008","435666","22785","-12571","-2.885","22.756","2388","8.873","2877","10.689","26670","1859","1879","8851","15427","34143","49570","11.378","3.541","43166","62141","18975","14.263","4.355"
"Texas","2009","418751","21816","-19071","-4.554","20.513","2020","7.724","3117","11.918","25605","1942","1970","9605","12890","30059","42949","10.256","3.078","45181","62020","16839","14.811","4.021"
"Texas","2010","402869","21419","-15565","-3.864","21.102","2279","8.959","2528","9.938","25314","1587","1596","7382","16602","25904","42506","10.551","4.121","41766","58071","16305","14.414","4.047"
"Texas","2011","399393","21187","8792","2.201","20.235","2269","8.994","2362","9.362","25182","1456","1479","6391","15204","33996","49200","12.319","3.807","26554","40408","13854","10.117","3.469"
"Texas","2012","403891","21228","-13","-0.003","22.828","2314","9.195","2254","8.957","25196","1352","1370","6460","13176","32925","46101","11.414","3.262","33119","46114","12995","11.417","3.217"
"Texas","2013","405786","21078","4432","1.092","19.89","2156","8.583","2206","8.782","25095","1372","1385","6887","12162","32626","44788","11.037","2.997","28045","40356","12311","9.945","3.034"
"Texas","2014","413798","20990","12711","3.072","18.601","2198","8.753","2089","8.319","25167","1350","1360","6707","17711","33485","51196","12.372","4.28","26706","38485","11779","9.3","2.847"
"Texas","2015","421619","21181","4731","1.122","19.679","2293","9.078","2040","8.077","25384","1252","1273","7295","13531","32686","46217","10.962","3.209","29729","41486","11757","9.84","2.789"
"Texas","2016","427924","21512","8705","2.034","19.248","2547","9.926","1954","7.615","25956","1335","1350","6876","16815","33074","49889","11.658","3.929","30128","41184","11056","9.624","2.584"
"Texas","2017","433924","21551","3733","0.86","21.661","2067","7.973","2068","7.976","25926","1337","1356","8486","13164","37565","50729","11.691","3.034","31510","46996","15486","10.83","3.569"
"Texas","2018","438948","21507","7763","1.769","21.177","2077","8.051","2146","8.318","25765","1458","1503","8123","14729","39513","54242","12.357","3.356","29808","46479","16671","10.589","3.798"
"Utah","1978","878370","44522","66124","7.528","24.837","8324","16.228","5972","11.642","52471","3936","3983","16558","66311","108895","175206","19.947","7.549","62183","109082","46899","12.419","5.339"
"Utah","1979","937566","45418","42552","4.539","24.71","7627","14.388","5793","10.929","53925","3883","3950","19133","55485","102902","158387","16.893","5.918","74681","115835","41154","12.355","4.389"
"Utah","1980","943709","45544","12581","1.333","27.501","7211","13.334","6152","11.376","54608","4384","4480","19661","54656","87688","142344","15.083","5.792","91286","129763","38477","13.75","4.077"
"Utah","1981","953375","46088","10642","1.116","28.016","7058","12.853","5634","10.259","55627","3727","3800","17025","59922","84270","144192","15.124","6.285","96408","133550","37142","14.008","3.896"
"Utah","1982","951932","45731","-8249","-0.867","30.5","7179","12.948","6680","12.048","55695","4711","4763","22947","60735","84436","145171","15.25","6.38","111486","153420","41934","16.117","4.405"
"Utah","1983","941508","46743","-385","-0.041","32.077","7709","13.785","5699","10.191","56928","4023","4080","20973","61810","89193","151003","16.038","6.565","108246","151388","43142","16.079","4.582"
"Utah","1984","973940","50161","68057","6.988","23.676","10064","17.139","6050","10.303","60727","4598","4642","25166","65887","117465","183352","18.826","6.765","71318","115295","43977","11.838","4.515"
"Utah","1985","1046519","51726","42324","4.044","27.353","8898","14.531","6171","10.077","62599","4440","4504","26421","67016","118434","185450","17.721","6.404","93913","143126","49213","13.676","4.703"
"Utah","1986","1055780","52962","35644","3.376","30.128","8929","14.196","6281","9.986","64222","4330","4413","26038","77872","116813","194685","18.44","7.376","101319","159041","57722","15.064","5.467"
"Utah","1987","1103744","54458","54184","4.909","31.06","9743","14.995","6668","10.262","66514","4525","4603","27279","101707","123888","225595","20.439","9.215","105295","171411","66116","15.53","5.99"
"Utah","1988","1169876","56653","45704","3.907","32.862","9960","14.659","6724","9.896","69562","4739","4842","30312","99884","138045","237929","20.338","8.538","101014","192225","91211","16.431","7.797"
"Utah","1989","1209417","57990","53659","4.437","26.345","9543","13.63","6780","9.684","71397","4819","4908","28805","79666","133301","212967","17.609","6.587","104067","159308","55241","13.172","4.568"
"Utah","1990","1254272","59373","54946","4.381","25.847","9603","13.345","7065","9.818","73227","5142","5284","31982","83392","133652","217044","17.304","6.649","106894","162098","55204","12.924","4.401"
"Utah","1991","1270889","59460","-23834","-1.875","30.19","9698","13.217","7752","10.565","74346","5425","5608","39647","83932","107908","191840","15.095","6.604","149443","215674","66231","16.97","5.211"
"Utah","1992","1265231","59667","25006","1.976","28.171","8740","11.804","7557","10.206","74634","5084","5176","30354","77161","126060","203221","16.062","6.099","124147","178215","54068","14.086","4.273"
"Utah","1993","1293165","61003","32454","2.51","25.587","8953","11.901","7290","9.69","76061","4854","4961","26168","68018","129877","197895","15.303","5.26","110322","165441","55119","12.793","4.262"
"Utah","1994","1331369","62384","41968","3.152","25.93","9342","12.149","7400","9.623","77868","5053","5173","34232","81715","132864","214579","16.117","6.138","108435","172611","64176","12.965","4.82"
"Utah","1995","1374760","64135","47837","3.48","24.665","9970","12.651","7458","9.464","80061","5205","5382","35358","80116","137260","217376","15.812","5.828","107560","169539","61979","12.332","4.508"
"Utah","1996","1403721","65273","26654","1.899","27.042","10114","12.545","7927","9.832","81716","5487","5646","34198","81752","134698","216450","15.42","5.824","128874","189796","60922","13.521","4.34"
"Utah","1997","1435866","66654","38106","2.654","28.976","10761","13.033","8516","10.314","83690","5673","5813","41755","94685","151449","246134","17.142","6.594","131155","208028","76873","14.488","5.354"
"Utah","1998","1502386","68206","61845","4.116","26.665","10311","12.177","8232","9.722","85713","5306","5415","31944","89626","172521","262147","17.449","5.966","129208","200302","71094","13.332","4.732"
"Utah","1999","1547036","69402","32578","2.106","27.638","10305","11.932","8316","9.629","87361","5391","5654","34743","87858","158502","246360","15.925","5.679","141194","213782","72588","13.819","4.692"
"Utah","2000","1591852","69697","31767","1.996","28.226","9707","11.094","8669","9.908","88017","5520","5718","37183","86916","169510","256426","16.109","5.46","146939","224659","77720","14.113","4.882"
"Utah","2001","1603745","69532","-7917","-0.494","30.027","9755","11.092","9116","10.366","88265","5793","6030","39541","88881","151897","240778","15.013","5.542","165077","248695","83618","15.507","5.214"
"Utah","2002","1574083","69864","-74216","-4.715","28.88","10365","11.703","9411","10.626","89044","5794","5970","51190","87466","139835","227301","14.44","5.557","203849","301517","97668","19.155","6.205"
"Utah","2003","1540960","70856","9834","0.638","29.62","10042","11.219","8591","9.598","90235","5444","5530","35902","91592","146459","238051","15.448","5.944","148512","228217","79705","14.81","5.172"
"Utah","2004","1557628","72166","11805","0.758","27.186","10095","11.098","8203","9.018","91907","5326","5429","33977","78048","145487","223535","14.351","5.011","142958","211730","68772","13.593","4.415"
"Utah","2005","1579218","73843","23994","1.519","26.644","11018","11.852","8487","9.129","94230","5678","5787","34218","86701","147680","234381","14.842","5.49","147655","210387","62732","13.322","3.972"
"Utah","2006","1619350","75546","56330","3.479","25.591","12284","12.87","9201","9.64","96988","6520","6673","36909","101281","162256","263537","16.274","6.254","139048","207207","68159","12.796","4.209"
"Utah","2007","1653342","76490","9609","0.581","29.289","11554","11.818","9234","9.445","98928","6063","6211","38625","87212","164522","251734","15.226","5.275","164911","242125","77214","14.645","4.67"
"Utah","2008","1657957","75605","3291","0.198","27.664","9730","9.872","9933","10.078","98463","6662","6772","36199","72443","160176","232619","14.03","4.369","158280","229328","71048","13.832","4.285"
"Utah","2009","1599454","72832","-110549","-6.912","21.821","8679","8.94","11375","11.717","95730","7412","7693","42526","72735","101775","174510","10.911","4.547","208218","285059","76841","17.822","4.804"
"Utah","2010","1526278","71284","-47665","-3.123","22.922","8484","8.944","9635","10.158","94278","6127","6307","32550","66681","108246","174927","11.461","4.369","162193","222592","60399","14.584","3.957"
"Utah","2011","1514698","70171","27966","1.846","23.353","8400","8.969","8978","9.586","93372","5799","5979","30763","63194","141636","204830","13.523","4.172","123531","176864","53333","11.677","3.521"
"Utah","2012","1538518","70237","31977","2.078","22.351","8245","8.849","7941","8.523","93322","4778","4914","23833","56914","147001","203915","13.254","3.699","122193","171938","49745","11.176","3.233"
"Utah","2013","1566802","70452","27525","1.757","21.237","8307","8.907","7731","8.289","93556","4825","4938","24317","58276","135621","193897","12.375","3.719","116429","166372","49943","10.619","3.188"
"Utah","2014","1589460","70750","44185","2.78","19.785","8604","9.17","7609","8.11","94321","4932","5027","25089","63261","138158","201419","12.672","3.98","108995","157234","48239","9.892","3.035"
"Utah","2015","1638302","71684","49322","3.011","19.856","9115","9.605","7369","7.765","95774","4803","4898","27061","71070","140906","211976","12.939","4.338","111752","162654","50902","9.928","3.107"
"Utah","2016","1691797","73031","54798","3.239","20.149","9458","9.767","6882","7.107","98126","4708","4842","27324","76385","148852","225237","13.313","4.515","120137","170439","50302","10.074","2.973"
"Utah","2017","1729132","73981","33413","1.932","22.406","9083","9.211","7522","7.628","99396","4824","4936","32923","68281","158846","227127","13.135","3.949","129266","193714","64448","11.203","3.727"
"Utah","2018","1778704","75156","44899","2.524","21.984","9027","9.041","7676","7.688","100519","5388","5601","31385","72923","167491","240414","13.516","4.1","135335","195515","60180","10.992","3.383"
"Vermont","1978","161080","14246","16918","10.503","26.79","2317","14.777","1693","10.797","15992","1177","1184","4575","13462","25033","38495","23.898","8.357","13487","21577","8090","13.395","5.022"
"Vermont","1979","174809","14794","9789","5.6","27.128","2241","13.762","1508","9.26","16651","1083","1087","5042","13125","20375","33500","19.164","7.508","15121","23711","8590","13.564","4.914"
"Vermont","1980","178358","14703","-1997","-1.12","32.692","1899","11.457","1836","11.077","16607","1272","1280","5587","11886","17268","29154","16.346","6.664","19403","31151","11748","17.465","6.587"
"Vermont","1981","175110","14579","-3586","-2.048","27.684","1733","10.496","1629","9.866","16563","1148","1158","4779","9713","14526","24239","13.842","5.547","19088","27825","8737","15.89","4.989"
"Vermont","1982","173016","14236","-1502","-0.868","31.113","1815","11.151","1951","11.986","16209","1348","1366","5511","11691","15224","26915","15.556","6.757","19555","28417","8862","16.425","5.122"
"Vermont","1983","170759","14515","969","0.567","29.327","1900","11.712","1370","8.445","16487","934","952","4443","9713","16295","26008","15.231","5.688","18019","25039","7020","14.663","4.111"
"Vermont","1984","174868","15043","11151","6.377","23.887","2209","13.274","1379","8.286","17057","998","1009","3937","11444","20592","32036","18.32","6.544","13353","20885","7532","11.943","4.307"
"Vermont","1985","184035","15024","8544","4.643","25.974","1978","11.7","1703","10.073","17044","1225","1252","5636","13728","18717","32445","17.63","7.459","15905","23901","7996","12.987","4.345"
"Vermont","1986","186521","14919","-1182","-0.634","29.902","1807","10.727","1587","9.421","16955","1108","1115","5289","10786","17101","27887","14.951","5.783","20413","29069","8656","15.585","4.641"
"Vermont","1987","188067","15008","9018","4.795","26.709","2003","11.905","1539","9.147","17057","1090","1095","4854","14469","19664","34133","18.149","7.694","17122","25115","7993","13.354","4.25"
"Vermont","1988","196946","15322","7907","4.015","26.464","1974","11.445","1481","8.587","17494","1042","1067","5018","13563","20404","33967","17.247","6.887","16807","26060","9253","13.232","4.698"
"Vermont","1989","203801","15526","8992","4.412","23.884","1945","11.079","1437","8.186","17809","1055","1068","5044","9660","23670","33330","16.354","4.74","15098","24338","9240","11.942","4.534"
"Vermont","1990","213259","15941","12324","5.779","23.016","2134","11.884","1463","8.147","18292","1070","1085","4560","13839","23027","36866","17.287","6.489","15102","24542","9440","11.508","4.427"
"Vermont","1991","222107","16101","8917","4.015","25.595","2136","11.607","1501","8.157","18720","1097","1109","6043","13993","23348","37341","16.812","6.3","19116","28424","9308","12.797","4.191"
"Vermont","1992","232360","16229","11973","5.153","24.225","2007","10.72","1598","8.535","18927","1069","1080","5339","13226","26891","40117","17.265","5.692","19256","28144","8888","12.112","3.825"
"Vermont","1993","243330","16582","10857","4.462","22.798","1938","10.18","1573","8.263","19219","1036","1056","5131","12132","26462","38594","15.861","4.986","18504","27737","9233","11.399","3.794"
"Vermont","1994","253911","17069","9156","3.606","23.044","2163","11.078","1553","7.953","19831","1105","1126","5726","12937","25475","38412","15.128","5.095","19334","29256","9922","11.522","3.908"
"Vermont","1995","264636","17421","12653","4.781","20.032","2070","10.339","1572","7.851","20271","1131","1153","5457","12249","26910","39159","14.797","4.629","16756","26506","9750","10.016","3.684"
"Vermont","1996","271026","17582","4730","1.745","24.514","2146","10.571","1739","8.566","20504","1257","1291","6468","15776","22173","37949","14.002","5.821","22340","33219","10879","12.257","4.014"
"Vermont","1997","276448","17645","6228","2.253","26.156","2223","10.825","1993","9.705","20650","1310","1353","6908","15513","26869","42382","15.331","5.612","24067","36154","12087","13.078","4.372"
"Vermont","1998","287090","17893","9815","3.419","22.386","2132","10.251","1860","8.943","20934","1286","1323","6270","12283","29666","41949","14.612","4.278","20687","32134","11447","11.193","3.987"
"Vermont","1999","294671","17955","5935","2.014","23.092","2085","9.931","1868","8.898","21103","1308","1346","6276","14744","25214","39958","13.56","5.004","22794","34023","11229","11.546","3.811"
"Vermont","2000","303212","18044","9116","3.006","25.108","1990","9.412","1824","8.627","21226","1228","1273","5954","14993","32188","47181","15.56","4.945","25405","38065","12660","12.554","4.175"
"Vermont","2001","310610","18064","4878","1.57","26.015","2047","9.625","1889","8.882","21347","1230","1253","6411","21243","24037","45280","14.578","6.839","27237","40402","13165","13.007","4.238"
"Vermont","2002","306779","18287","-12501","-4.075","28.274","2409","11.187","1964","9.12","21757","1274","1294","9206","16403","26967","43370","14.137","5.347","37062","55871","18809","18.212","6.131"
"Vermont","2003","301453","18425","1901","0.631","25.972","2109","9.695","1964","9.028","21826","1186","1204","6285","12485","28563","41048","13.617","4.142","25235","39147","13912","12.986","4.615"
"Vermont","2004","305687","18732","8650","2.83","23.597","2186","9.947","1766","8.036","22186","1137","1144","4944","13620","31097","44717","14.628","4.456","23081","36067","12986","11.799","4.248"
"Vermont","2005","312970","19096","5852","1.87","22.292","2270","10.144","1839","8.218","22593","1194","1213","5449","11446","29289","40735","13.016","3.657","24334","34883","10549","11.146","3.371"
"Vermont","2006","322402","19292","13302","4.126","20.81","2706","11.924","2265","9.98","22915","1655","1683","7857","17105","29743","46848","14.531","5.305","22094","33546","11452","10.405","3.552"
"Vermont","2007","329099","19425","2909","0.884","25.097","2340","10.176","1954","8.497","23188","1269","1280","6363","14456","29750","44206","13.432","4.393","28876","41297","12421","12.549","3.774"
"Vermont","2008","333813","19327","7405","2.218","23.191","2123","9.17","2028","8.76","23198","1402","1416","6695","13755","32358","46113","13.814","4.121","24619","38708","14089","11.596","4.221"
"Vermont","2009","334206","19201","-6633","-1.985","22.245","1914","8.262","2046","8.832","23100","1358","1368","7596","11562","25610","37172","11.122","3.46","32083","43805","11722","13.107","3.507"
"Vermont","2010","330005","19203","-1799","-0.545","22.335","1951","8.435","1800","7.782","23205","1164","1173","5968","13223","23630","36853","11.167","4.007","28230","38652","10422","11.713","3.158"
"Vermont","2011","326950","19087","-2626","-0.803","21.069","1875","8.096","1819","7.854","23187","1178","1211","6068","9731","24712","34443","10.535","2.976","27509","37069","9560","11.338","2.924"
"Vermont","2012","328790","19219","6852","2.084","21.302","2054","8.83","1758","7.557","23410","1138","1157","5043","12754","29117","41871","12.735","3.879","23278","35019","11741","10.651","3.571"
"Vermont","2013","335595","19281","7666","2.284","19.299","1917","8.182","1736","7.409","23521","1126","1134","5437","10025","30025","40050","11.934","2.987","22952","32384","9432","9.65","2.811"
"Vermont","2014","343348","19326","8105","2.361","17.949","1884","8.001","1721","7.309","23629","1172","1192","5445","11538","27380","38918","11.335","3.36","22439","30813","8374","8.974","2.439"
"Vermont","2015","349772","19559","5729","1.638","17.666","2078","8.738","1640","6.896","24001","1123","1148","5889","11219","25406","36625","10.471","3.208","21265","30896","9631","8.833","2.754"
"Vermont","2016","355407","19746","5247","1.476","17.189","2071","8.571","1651","6.833","24373","1189","1204","4937","10482","25311","35793","10.071","2.949","23042","30546","7504","8.595","2.111"
"Vermont","2017","358056","19758","1700","0.475","21.912","1912","7.854","1840","7.558","24381","1214","1229","6156","11617","29312","40929","11.431","3.244","27795","39229","11434","10.956","3.193"
"Vermont","2018","359068","19818","32","0.009","20.05","1923","7.889","1824","7.483","24424","1351","1393","6935","10274","25754","36028","10.034","2.861","24546","35996","11450","10.025","3.189"
"Virginia","1978","1311133","67793","97599","7.444","28.076","12256","15.485","9601","12.13","80476","6449","6511","34319","99324","182331","281655","21.482","7.575","97511","184056","86545","14.038","6.601"
"Virginia","1979","1395653","69416","64490","4.621","27.84","11840","14.577","9250","11.388","82518","6179","6230","34420","97621","161141","258762","18.541","6.995","117018","194272","77254","13.92","5.535"
"Virginia","1980","1425189","69014","-4781","-0.335","30.843","10764","13.063","9730","11.809","82915","6959","7050","38169","91565","128224","219789","15.422","6.425","153734","224570","70836","15.757","4.97"
"Virginia","1981","1417528","69100","-4098","-0.289","30.137","10165","12.275","8951","10.809","83416","6070","6156","31398","86427","127172","213599","15.068","6.097","150041","217697","67656","15.358","4.773"
"Virginia","1982","1408186","68206","-9924","-0.705","32.12","10990","13.259","10490","12.656","83138","7367","7472","35742","96767","129391","226158","16.06","6.872","167715","236082","68367","16.765","4.855"
"Virginia","1983","1406238","69415","24080","1.712","33.266","11205","13.53","8904","10.752","83966","5846","5943","35821","119916","138062","257978","18.345","8.527","156138","233898","77760","16.633","5.53"
"Virginia","1984","1478934","73903","115587","7.816","24.457","14011","16.267","7561","8.779","89354","5686","5786","32716","113835","182603","296438","20.044","7.697","117265","180851","63586","12.228","4.299"
"Virginia","1985","1559697","75079","74241","4.76","27.542","12637","14.143","9596","10.74","90871","6830","6912","38195","109982","179047","289029","18.531","7.052","132325","214788","82463","13.771","5.287"
"Virginia","1986","1613685","76149","70904","4.394","28.167","12675","13.959","9448","10.405","92412","6609","6726","43112","110122","188043","298165","18.477","6.824","146948","227261","80313","14.083","4.977"
"Virginia","1987","1672909","78039","12033","0.719","36.936","13965","14.972","9674","10.371","95421","6684","6768","47470","127172","193813","320985","19.187","7.602","217304","308952","91648","18.468","5.478"
"Virginia","1988","1731504","80530","85849","4.958","31.005","14336","14.731","9880","10.152","99549","6825","6953","47322","154571","199703","354274","20.46","8.927","167062","268425","101363","15.502","5.854"
"Virginia","1989","1801530","82267","72003","3.997","28.584","14001","13.963","9908","9.881","102321","6986","7220","46671","129518","199957","329475","18.289","7.189","167404","257472","90068","14.292","5.0"
"Virginia","1990","1855924","83304","58624","3.159","26.59","12865","12.543","10105","9.852","103950","7294","7450","47368","116097","189269","305366","16.454","6.255","163429","246742","83313","13.295","4.489"
"Virginia","1991","1864250","82729","-29356","-1.575","30.238","12845","12.393","10733","10.355","104707","7564","7744","61015","115509","166343","281852","15.119","6.196","209017","311208","102191","16.693","5.482"
"Virginia","1992","1876388","83344","78151","4.165","26.989","12306","11.784","10184","9.752","105493","6671","6828","44036","116626","214734","331360","17.659","6.215","167453","253209","85756","13.494","4.57"
"Virginia","1993","1932018","85684","37919","1.963","28.674","12594","11.83","10003","9.396","107751","6534","6765","42959","106970","207940","314910","16.3","5.537","176480","276991","100511","14.337","5.202"
"Virginia","1994","1986132","87782","73090","3.68","25.658","12960","11.88","10001","9.168","110566","6870","7027","46558","125224","202662","327886","16.509","6.305","155300","254796","99496","12.829","5.01"
"Virginia","1995","2072613","90160","113127","5.458","23.573","13593","12.144","10144","9.063","113655","6944","7148","45629","128841","228577","357418","17.245","6.216","160339","244291","83952","11.787","4.051"
"Virginia","1996","2134023","91333","29281","1.372","28.247","13810","12.073","10872","9.504","115860","7679","7832","54858","128977","201698","330675","15.495","6.044","195020","301394","106374","14.123","4.985"
"Virginia","1997","2181251","92008","51692","2.37","29.89","14253","12.236","12236","10.504","117493","8144","8412","58658","136675","241007","377682","17.315","6.266","213080","325990","112910","14.945","5.176"
"Virginia","1998","2264536","92722","74649","3.296","27.068","13611","11.509","11868","10.035","119135","7767","7978","48850","146683","234446","381129","16.83","6.477","200201","306480","106279","13.534","4.693"
"Virginia","1999","2325569","92369","29743","1.279","29.373","13240","11.106","12196","10.23","119736","7931","8243","55431","140299","230986","371285","15.965","6.033","217503","341542","124039","14.686","5.334"
"Virginia","2000","2352006","91683","51915","2.207","28.332","12494","10.461","12283","10.285","119537","7723","7980","47953","126442","258663","385105","16.373","5.376","205621","333190","127569","14.166","5.424"
"Virginia","2001","2364778","90653","-11193","-0.473","30.265","12535","10.529","12445","10.453","119097","7666","7996","63764","129858","227988","357846","15.132","5.491","244263","369039","124776","15.606","5.276"
"Virginia","2002","2335817","90226","-69344","-2.969","31.291","13290","11.157","13224","11.102","119148","7871","8139","67237","135790","229664","365454","15.646","5.813","288580","434798","146218","18.614","6.26"
"Virginia","2003","2298664","90519","-2259","-0.098","30.533","12716","10.67","11914","9.997","119577","7241","7458","45906","128658","222268","350926","15.267","5.597","239193","353185","113992","15.365","4.959"
"Virginia","2004","2316427","91921","38025","1.642","26.241","12683","10.542","10688","8.883","121312","6785","6986","43678","112848","229103","341951","14.762","4.872","202183","303926","101743","13.12","4.392"
"Virginia","2005","2347331","92912","22580","0.962","26.564","13357","10.947","11386","9.331","123005","7386","7596","46562","111974","222380","334354","14.244","4.77","219832","311774","91942","13.282","3.917"
"Virginia","2006","2403716","94109","90955","3.784","24.107","15220","12.268","12184","9.821","125581","8300","8512","48906","140263","240420","380683","15.837","5.835","193650","289728","96078","12.053","3.997"
"Virginia","2007","2454547","94917","22406","0.913","29.107","13904","11.014","11806","9.352","127289","7275","7427","46279","123199","256429","379628","15.466","5.019","242090","357222","115132","14.553","4.691"
"Virginia","2008","2474428","94198","9400","0.38","27.937","12879","10.113","12086","9.49","127751","7982","8088","45781","121550","233488","355038","14.348","4.912","252967","345638","92671","13.968","3.745"
"Virginia","2009","2400234","91537","-170711","-7.112","21.245","10666","8.44","13430","10.627","124994","8510","8755","54580","91645","163320","254965","10.623","3.818","317007","425676","108669","17.735","4.527"
"Virginia","2010","2287853","89792","-50721","-2.217","23.304","10332","8.338","11671","9.419","123238","7268","7496","45522","87164","179417","266581","11.652","3.81","224600","317302","92702","13.869","4.052"
"Virginia","2011","2279179","88756","35884","1.574","22.298","10520","8.587","11249","9.182","122145","7053","7289","40888","78706","211289","289995","12.724","3.453","170764","254111","83347","11.149","3.657"
"Virginia","2012","2325321","88439","54438","2.341","21.752","10566","8.675","10406","8.544","121874","6275","6446","37850","84250","223085","307335","13.217","3.623","173558","252897","79339","10.876","3.412"
"Virginia","2013","2373069","88528","43336","1.826","22.843","10823","8.881","10001","8.206","122279","6191","6348","36864","92678","221704","314382","13.248","3.905","186321","271046","84725","11.422","3.57"
"Virginia","2014","2423595","88495","57993","2.393","19.763","10830","8.837","9664","7.886","123135","6198","6320","35660","91208","206269","297477","12.274","3.763","169516","239484","69968","9.881","2.887"
"Virginia","2015","2474001","88746","56782","2.295","20.41","11267","9.111","9472","7.66","124556","6074","6229","45000","99676","209577","309253","12.5","4.029","176422","252471","76049","10.205","3.074"
"Virginia","2016","2540629","89684","80809","3.181","18.894","11361","9.046","8753","6.97","126889","5977","6131","34986","102531","218291","320822","12.628","4.036","172878","240013","67135","9.447","2.642"
"Virginia","2017","2619504","90372","44341","1.693","22.726","11081","8.713","9826","7.726","127806","6232","6420","43350","99504","242495","341999","13.056","3.799","199250","297658","98408","11.363","3.757"
"Virginia","2018","2650802","90920","33454","1.262","20.601","10314","8.067","9469","7.406","128284","6578","6929","43427","87340","219155","306495","11.562","3.295","192972","273041","80069","10.3","3.021"
"Washington","1978","4121058","227427","428476","10.397","32.631","49343","18.235","34422","12.721","278050","23341","23722","149049","433025","667818","1100843","26.713","10.508","377185","672367","295182","16.315","7.163"
"Washington","1979","4487801","236050","304071","6.776","32.901","48166","17.102","32940","11.696","289255","22842","23179","155696","410610","631727","1042337","23.226","9.149","444468","738266","293798","16.451","6.547"
"Washington","1980","4743554","240246","182069","3.838","34.365","46824","16.044","35598","12.197","297467","24775","25249","149829","396496","600634","997130","21.021","8.359","544672","815061","270389","17.182","5.7"
"Washington","1981","4960039","249813","291611","5.879","30.779","49059","16.196","32354","10.681","311260","21117","21600","125228","421694","633230","1054924","21.268","8.502","515697","763313","247616","15.389","4.992"
"Washington","1982","5276318","257076","357069","6.767","32.791","52102","16.511","37727","11.956","322748","26647","27176","160720","493512","728623","1222135","23.163","9.353","574240","865066","290826","16.395","5.512"
"Washington","1983","5341186","267963","-174552","-3.268","37.7","53104","16.271","35824","10.976","335014","24695","25348","165170","421292","585514","1006806","18.85","7.888","870698","1181358","310660","22.118","5.816"
"Washington","1984","5358714","279693","350844","6.547","32.699","57368","16.918","38415","11.328","348577","27688","28388","167241","492866","734108","1226974","22.897","9.197","587721","876130","288409","16.35","5.382"
"Washington","1985","5557688","283127","253156","4.555","34.365","55117","15.846","44848","12.894","352953","32771","33459","213605","489192","718905","1208097","21.737","8.802","593504","954941","361437","17.182","6.503"
"Washington","1986","5584753","281997","2850","0.051","38.66","52706","15.063","44045","12.588","354225","31941","32612","207974","456628","625743","1082371","19.381","8.176","717074","1079521","362447","19.33","6.49"
"Washington","1987","5472883","274390","-147302","-2.691","38.728","50678","14.587","50269","14.47","347615","34459","35371","229608","486651","573114","1059765","19.364","8.892","765550","1207067","441517","22.055","8.067"
"Washington","1988","5447253","275544","98589","1.81","38.017","51062","14.635","45556","13.057","351665","31610","32641","201127","486445","647579","1134024","20.818","8.93","644899","1035435","390536","19.008","7.169"
"Washington","1989","5549055","275468","215168","3.878","32.758","48816","13.982","41791","11.97","352658","29182","30412","198128","443116","680943","1124059","20.257","7.985","557707","908891","351184","16.379","6.329"
"Washington","1990","5757979","279876","279126","4.848","30.16","49305","13.964","38357","10.863","358562","27157","28210","193549","442887","704554","1147441","19.928","7.692","546269","868315","322046","15.08","5.593"
"Washington","1991","5884319","281461","124114","2.109","34.305","50131","13.979","39292","10.957","364026","27162","28134","222726","473444","659968","1133412","19.262","8.046","632626","1009298","376672","17.152","6.401"
"Washington","1992","5969943","285890","79942","1.339","35.452","48964","13.446","38108","10.465","369574","24733","25592","177459","447525","690656","1138181","19.065","7.496","708415","1058239","349824","17.726","5.86"
"Washington","1993","6077759","293974","147352","2.424","33.45","48425","13.006","40400","10.851","376335","25993","26922","178048","413649","750196","1163845","19.149","6.806","638043","1016493","378450","16.725","6.227"
"Washington","1994","6277413","301983","197302","3.143","30.165","50686","13.291","40078","10.51","386647","27337","28208","190026","429501","714585","1144086","18.225","6.842","607233","946784","339551","15.082","5.409"
"Washington","1995","6519773","309080","309714","4.75","28.737","51770","13.247","40904","10.467","396239","27987","28979","187974","473305","773213","1246518","19.119","7.26","598458","936804","338346","14.369","5.19"
"Washington","1996","6710971","313858","184067","2.743","31.094","51779","13.008","42502","10.678","402685","29133","30146","200828","477435","749988","1227423","18.29","7.114","677360","1043356","365996","15.547","5.454"
"Washington","1997","6959319","317026","267476","3.843","33.418","53361","13.18","46565","11.501","408261","30822","31889","229970","547023","883281","1430304","20.552","7.86","728043","1162828","434785","16.709","6.248"
"Washington","1998","7362956","322657","342781","4.655","30.227","51900","12.582","43930","10.65","416463","27959","29203","182895","528934","926629","1455563","19.769","7.184","727686","1112782","385096","15.113","5.23"
"Washington","1999","7615327","323206","150216","1.973","33.309","50983","12.201","45282","10.836","420717","29518","30626","229755","502407","916110","1418517","18.627","6.597","785782","1268301","482519","16.655","6.336"
"Washington","2000","7843183","324034","271294","3.459","31.095","49957","11.852","46043","10.923","423465","28696","30041","203739","532368","958336","1490704","19.006","6.788","739808","1219410","479602","15.547","6.115"
"Washington","2001","8065590","325896","165465","2.051","32.327","51806","12.181","45624","10.728","428387","28281","29337","218278","564444","904689","1469133","18.215","6.998","816181","1303668","487487","16.163","6.044"
"Washington","2002","8068137","328356","-240811","-2.985","36.491","55260","12.822","49360","11.453","433938","29510","30817","274721","631223","840866","1472089","18.246","7.824","1107189","1712900","605711","21.23","7.507"
"Washington","2003","7964509","332113","20188","0.253","34.04","52171","11.985","46827","10.757","437989","28596","29376","205349","496842","878922","1375764","17.274","6.238","861224","1355576","494352","17.02","6.207"
"Washington","2004","8025983","336488","93589","1.166","31.15","52264","11.859","45110","10.236","444293","28788","29612","199667","499667","843960","1343627","16.741","6.226","808380","1250038","441658","15.575","5.503"
"Washington","2005","8163402","341855","141450","1.733","29.494","54322","12.124","45232","10.095","452612","29355","30133","198092","509114","836206","1345320","16.48","6.237","813704","1203870","390166","14.747","4.779"
"Washington","2006","8461759","348338","442080","5.224","26.391","62288","13.59","48464","10.574","465253","32783","33564","210567","591806","966843","1558649","18.42","6.994","712051","1116569","404518","13.195","4.781"
"Washington","2007","8826593","353628","290976","3.297","29.95","59226","12.622","47798","10.187","474932","29375","30100","199835","556964","1055775","1612739","18.271","6.31","864398","1321763","457365","14.975","5.182"
"Washington","2008","9043949","356036","172871","1.911","29.335","53706","11.269","48109","10.095","479369","30540","31483","201637","519140","980268","1499408","16.579","5.74","914708","1326537","411829","14.668","4.554"
"Washington","2009","9013772","354465","-292977","-3.25","26.659","49359","10.287","49652","10.348","479684","31622","32532","205906","451021","750486","1201507","13.33","5.004","1078041","1494484","416443","16.58","4.62"
"Washington","2010","8808280","354116","-116679","-1.325","27.036","48756","10.16","46214","9.631","481141","28841","29631","179424","462461","728223","1190684","13.518","5.25","937344","1307363","370019","14.842","4.201"
"Washington","2011","8849096","356070","187080","2.114","25.269","50691","10.501","45172","9.358","485469","28995","29848","174149","426814","878305","1305119","14.749","4.823","792241","1118039","325798","12.634","3.682"
"Washington","2012","9121787","362835","348089","3.816","24.09","52833","10.813","43802","8.965","493110","26280","27301","173846","456873","989929","1446802","15.861","5.009","732204","1098713","366509","12.045","4.018"
"Washington","2013","9448000","368983","294080","3.113","24.429","52928","10.661","43364","8.735","501242","26795","27384","172167","460189","987896","1448085","15.327","4.871","764755","1154005","389250","12.214","4.12"
"Washington","2014","9747398","375835","304761","3.127","23.536","54682","10.801","42625","8.419","512303","27401","28120","177443","492732","959101","1451833","14.895","5.055","763158","1147072","383914","11.768","3.939"
"Washington","2015","10074762","382263","319199","3.168","23.438","55202","10.686","44604","8.634","521882","28792","29655","187157","514198","985647","1499845","14.887","5.104","801583","1180646","379063","11.719","3.763"
"Washington","2016","10329951","388176","198865","1.925","24.132","57333","10.873","44713","8.48","533617","30774","31725","201780","511089","934176","1445265","13.991","4.948","895291","1246400","351109","12.066","3.399"
"Washington","2017","10478377","392983","148974","1.422","26.89","57060","10.649","50253","9.379","539225","32581","33684","225814","518685","1039109","1557794","14.867","4.95","948932","1408820","459888","13.445","4.389"
"Washington","2018","10665187","398649","228987","2.147","23.378","54923","10.141","47788","8.824","545159","34659","35987","231613","474098","1001535","1475633","13.836","4.445","854572","1246646","392074","11.689","3.676"
"West Virginia","1978","372559","22954","52561","14.108","31.444","4937","19.228","3304","12.868","26492","2268","2300","12287","45880","65255","111135","29.83","12.315","33522","58574","25052","15.722","6.724"
"West Virginia","1979","414252","23772","29359","7.087","32.79","4528","16.824","3339","12.406","27508","2284","2347","13399","38089","59186","97275","23.482","9.195","40737","67916","27179","16.395","6.561"
"West Virginia","1980","426247","23597","-4312","-1.012","37.365","4115","15.052","3795","13.882","27498","2685","2725","16582","31075","48558","79633","18.682","7.29","43505","83945","40440","19.694","9.487"
"West Virginia","1981","426769","24053","10462","2.451","33.879","4599","16.56","3368","12.128","28387","2316","2355","12375","36432","46322","82754","19.391","8.537","49156","72292","23136","16.939","5.421"
"West Virginia","1982","432066","23780","3392","0.785","35.811","4251","15.04","3894","13.777","28444","2707","2736","14743","33071","47684","80755","18.69","7.654","51722","77363","25641","17.905","5.935"
"West Virginia","1983","429057","24493","-3156","-0.736","37.456","4374","15.285","3107","10.857","29250","2091","2129","13403","32734","47619","80353","18.728","7.629","58342","83509","25167","19.463","5.866"
"West Virginia","1984","442583","25455","33883","7.656","26.819","4597","15.56","3081","10.429","30302","2154","2216","13164","34263","58968","93231","21.065","7.742","36276","59348","23072","13.409","5.213"
"West Virginia","1985","467014","25653","23045","4.935","29.338","4601","15.281","3823","12.697","30498","2736","2791","17336","33785","57766","91551","19.603","7.234","41497","68506","27009","14.669","5.783"
"West Virginia","1986","482923","25593","6894","1.428","36.69","4543","15.014","3745","12.377","30657","2629","2677","17228","40554","54933","95487","19.773","8.398","57214","88593","31379","18.345","6.498"
"West Virginia","1987","489435","25907","11115","2.271","36.69","4735","15.518","3761","12.326","30999","2513","2573","17331","40369","60534","100903","20.616","8.248","60562","89788","29226","18.345","5.971"
"West Virginia","1988","505536","26357","21873","4.327","34.377","4817","15.35","3895","12.412","31843","2672","2771","18957","49780","58987","108767","21.515","9.847","52292","86894","34602","17.188","6.845"
"West Virginia","1989","527322","26563","30358","5.757","32.476","4550","14.31","3729","11.728","32206","2617","2692","18886","45239","70746","115985","21.995","8.579","50722","85627","34905","16.238","6.619"
"West Virginia","1990","556636","27098","29985","5.387","27.717","4333","13.4","3277","10.135","32863","2325","2395","16230","37299","69828","107127","19.245","6.701","49413","77142","27729","13.859","4.982"
"West Virginia","1991","577761","27732","18725","3.241","30.53","4759","14.364","3244","9.792","33888","2290","2357","20077","42115","64806","106921","18.506","7.289","58459","88196","29737","15.265","5.147"
"West Virginia","1992","601778","28595","36240","6.022","28.671","4793","14.056","3345","9.81","34823","2184","2231","18106","42375","80133","122508","20.358","7.042","55288","86268","30980","14.336","5.148"
"West Virginia","1993","637226","29890","38004","5.964","25.749","4936","13.955","3447","9.745","36116","2267","2374","18532","40808","79235","120043","18.838","6.404","49862","82039","32177","12.874","5.05"
"West Virginia","1994","676865","31505","42904","6.339","25.737","5649","15.248","3578","9.658","38084","2492","2569","21279","47438","82570","130008","19.207","7.008","53379","87104","33725","12.869","4.983"
"West Virginia","1995","719123","33121","44172","6.142","26.597","5916","15.169","3848","9.867","40034","2716","2794","19476","54148","85655","139803","19.441","7.53","61572","95631","34059","13.298","4.736"
"West Virginia","1996","754713","34618","37761","5.003","27.115","6223","15.252","4224","10.352","41802","2990","3067","22164","57402","82678","140080","18.561","7.606","67735","102319","34584","13.557","4.582"
"West Virginia","1997","798295","36000","46817","5.865","30.739","6548","15.376","4856","11.403","43432","3237","3329","23934","64044","105466","169510","21.234","8.023","75041","122693","47652","15.369","5.969"
"West Virginia","1998","835159","37094","16554","1.982","33.701","6322","14.327","4953","11.225","44811","3258","3308","22102","58972","98310","157282","18.833","7.061","96749","140728","43979","16.85","5.266"
"West Virginia","1999","869599","38086","22404","2.576","30.25","6795","14.902","5043","11.059","46475","3407","3508","28822","60193","93739","153932","17.701","6.922","81543","131528","49985","15.125","5.748"
"West Virginia","2000","894299","38829","27858","3.115","29.405","6564","13.951","5213","11.079","47727","3475","3556","24366","59813","99529","159342","17.818","6.688","83729","131484","47755","14.702","5.34"
"West Virginia","2001","911030","39826","-396","-0.043","35.48","7040","14.601","5954","12.348","48760","3552","3645","29200","61999","99618","161617","17.74","6.805","99147","162013","62866","17.784","6.901"
"West Virginia","2002","908916","40793","-7451","-0.82","36.335","7522","15.244","6185","12.534","50013","3731","3807","30689","65322","99804","165126","18.167","7.187","115322","172577","57255","18.987","6.299"
"West Virginia","2003","900764","42261","-196","-0.022","34.004","7675","15.138","6134","12.098","51472","3823","3901","27527","61571","91576","153147","17.002","6.835","97948","153343","55395","17.024","6.15"
"West Virginia","2004","899589","43935","39171","4.354","29.282","7804","14.899","5880","11.226","53342","3730","3775","22684","62815","108067","170882","18.996","6.983","85923","131711","45788","14.641","5.09"
"West Virginia","2005","940223","45917","41072","4.368","28.677","8422","15.473","6126","11.255","55579","3896","3973","24373","61089","114799","175888","18.707","6.497","86426","134816","48390","14.339","5.147"
"West Virginia","2006","993687","48909","65067","6.548","24.792","10142","17.678","6453","11.248","59216","4468","4560","26864","70277","117968","188245","18.944","7.072","81563","123178","41615","12.396","4.188"
"West Virginia","2007","1063860","51497","51416","4.833","27.538","9622","15.873","6549","10.804","62155","4221","4246","24793","61874","136026","197900","18.602","5.816","94760","146484","51724","13.769","4.862"
"West Virginia","2008","1095788","51608","14695","1.341","30.931","8272","13.266","7762","12.448","62612","5302","5359","29070","57945","126218","184163","16.806","5.288","111101","169468","58367","15.465","5.326"
"West Virginia","2009","1076542","49427","-54447","-5.058","26.291","6920","11.218","9094","14.742","60602","6055","6121","36267","48908","92608","141516","13.145","4.543","138008","195963","57955","18.203","5.383"
"West Virginia","2010","1028779","48740","-39302","-3.82","24.983","7250","12.04","7887","13.098","59899","4988","5117","28321","50162","78348","128510","12.492","4.876","118268","167812","49544","16.312","4.816"
"West Virginia","2011","1014699","48798","10773","1.062","25.028","7264","12.114","6975","11.632","60108","4360","4464","24001","46016","91735","137751","13.576","4.535","87161","126978","39817","12.514","3.924"
"West Virginia","2012","1037484","49759","36407","3.509","22.829","7560","12.473","6336","10.453","61225","3982","4068","22059","46028","108804","154832","14.924","4.437","83039","118425","35386","11.415","3.411"
"West Virginia","2013","1073699","50826","38561","3.591","22.54","7444","12.041","6025","9.745","62534","3702","3747","21199","56125","103444","159569","14.862","5.227","79812","121008","41196","11.27","3.837"
"West Virginia","2014","1121128","52065","44363","3.957","21.733","7593","12.003","5988","9.466","64060","3876","3936","22020","55156","111037","166193","14.824","4.92","83924","121830","37906","10.867","3.381"
"West Virginia","2015","1175929","53276","54073","4.598","21.739","7876","12.136","6101","9.401","65786","4046","4140","23578","60254","121639","181893","15.468","5.124","89116","127820","38704","10.87","3.291"
"West Virginia","2016","1224637","54485","41630","3.399","21.075","7966","11.95","6137","9.206","67578","4190","4276","24831","52393","118285","170678","13.937","4.278","86626","129048","42422","10.538","3.464"
"West Virginia","2017","1256069","55748","41097","3.272","21.994","7964","11.679","6571","9.636","68889","4340","4416","27172","55322","123905","179227","14.269","4.404","90686","138130","47444","10.997","3.777"
"West Virginia","2018","1307408","57403","57936","4.431","19.784","8032","11.53","6345","9.108","70504","4672","4787","31152","57546","129718","187264","14.323","4.402","82671","129328","46657","9.892","3.569"
"Wisconsin","1978","150798","10888","12043","7.986","30.357","1912","16.35","1170","10.005","12065","851","860","8384","13145","21787","34932","23.165","8.717","10445","22889","12444","15.179","8.252"
"Wisconsin","1979","159960","11278","6493","4.059","26.155","1744","14.23","1225","9.996","12515","865","868","4319","9919","17493","27412","17.137","6.201","12863","20919","8056","13.078","5.036"
"Wisconsin","1980","163674","11307","919","0.561","29.77","1551","12.42","1450","11.612","12538","1001","1009","4091","8540","16742","25282","15.447","5.218","16312","24363","8051","14.885","4.919"
"Wisconsin","1981","166164","11428","4878","2.936","24.843","1486","11.825","1252","9.963","12684","856","864","3631","7879","17639","25518","15.357","4.742","15005","20640","5635","12.422","3.391"
"Wisconsin","1982","167594","11598","-570","-0.34","27.55","1778","13.937","1390","10.896","12951","996","1001","3850","8371","14715","23086","13.775","4.995","16210","23656","7446","14.115","4.443"
"Wisconsin","1983","166870","11842","247","0.148","27.365","1641","12.635","1208","9.301","13204","855","860","3481","8313","14766","23079","13.831","4.982","17565","22832","5267","13.683","3.156"
"Wisconsin","1984","172001","12747","10818","6.289","21.667","2123","15.59","1077","7.909","14141","797","801","3530","10219","19233","29452","17.123","5.941","12686","18634","5948","10.834","3.458"
"Wisconsin","1985","178941","13281","7051","3.94","25.683","2196","15.308","1458","10.164","14714","1080","1097","5220","11061","18969","30030","16.782","6.181","14319","22979","8660","12.842","4.84"
"Wisconsin","1986","185924","13651","10374","5.58","26.446","2245","15.16","1587","10.716","15138","1159","1167","5723","14078","20881","34959","18.803","7.572","15887","24585","8698","13.223","4.678"
"Wisconsin","1987","199256","14421","15004","7.53","26.351","2478","15.936","1471","9.46","16053","1070","1076","5872","17240","24017","41257","20.706","8.652","15536","26253","10717","13.176","5.379"
"Wisconsin","1988","209671","15204","6859","3.271","31.095","2512","15.246","1584","9.614","16940","1171","1182","6900","17575","21882","39457","18.819","8.382","21007","32598","11591","15.547","5.528"
"Wisconsin","1989","216611","15775","8093","3.736","25.428","2500","14.532","1682","9.777","17613","1318","1335","7011","13050","22583","35633","16.45","6.025","16296","27540","11244","12.714","5.191"
"Wisconsin","1990","217387","15801","-3262","-1.501","27.802","2078","11.819","1854","10.545","17694","1454","1466","6729","10527","19692","30219","13.901","4.843","23374","33481","10107","15.402","4.649"
"Wisconsin","1991","209782","15421","-8930","-4.257","25.876","1848","10.571","1910","10.926","17451","1437","1445","7884","11562","15580","27142","12.938","5.511","25391","36072","10681","17.195","5.091"
"Wisconsin","1992","206482","15304","933","0.452","28.487","1778","10.276","1712","9.895","17335","1171","1179","5682","10082","20261","30343","14.695","4.883","20833","29410","8577","14.243","4.154"
"Wisconsin","1993","208856","15593","5485","2.626","26.397","1958","11.207","1602","9.169","17650","1142","1168","4943","10794","22257","33051","15.825","5.168","16399","27566","11167","13.199","5.347"
"Wisconsin","1994","214385","15825","173","0.081","28.124","1835","10.324","1554","8.743","17915","1096","1116","5229","9907","20413","30320","14.143","4.621","20901","30147","9246","14.062","4.313"
"Wisconsin","1995","218130","16115","1594","0.731","27.6","1893","10.478","1522","8.424","18252","1092","1102","6798","10704","20992","31696","14.531","4.907","19039","30102","11063","13.8","5.072"
"Wisconsin","1996","221548","16157","1725","0.779","26.974","1897","10.39","1685","9.229","18364","1221","1242","6528","11825","19780","31605","14.266","5.337","17644","29880","12236","13.487","5.523"
"Wisconsin","1997","224825","16345","5610","2.495","25.515","2026","10.98","1767","9.576","18581","1242","1255","6079","14604","19688","34292","15.253","6.496","18284","28682","10398","12.757","4.625"
"Wisconsin","1998","233506","16496","8794","3.766","22.902","1859","9.978","1770","9.5","18676","1191","1221","5660","11501","24032","35533","15.217","4.925","17074","26739","9665","11.451","4.139"
"Wisconsin","1999","241407","16728","6851","2.838","22.562","1949","10.339","1537","8.153","19057","1130","1146","5854","11650","22434","34084","14.119","4.826","18165","27233","9068","11.281","3.756"
"Wisconsin","2000","249233","16774","9322","3.74","23.093","1819","9.528","1659","8.69","19171","1162","1172","5106","12683","25417","38100","15.287","5.089","19181","28778","9597","11.547","3.851"
"Wisconsin","2001","252511","16669","4232","1.676","22.372","1675","8.77","1587","8.309","19143","1118","1132","5871","10319","22159","32478","12.862","4.087","18898","28246","9348","11.186","3.702"
"Wisconsin","2002","256709","16561","-3127","-1.218","29.281","1839","9.617","1909","9.983","19088","1151","1177","6431","14195","23389","37584","14.641","5.53","26688","40711","14023","15.859","5.463"
"Wisconsin","2003","253789","16646","-2350","-0.926","26.257","1856","9.693","1613","8.424","19270","1002","1025","6103","10041","23278","33319","13.129","3.956","22780","35669","12889","14.055","5.079"
"Wisconsin","2004","253145","16911","-366","-0.145","21.54","1842","9.502","1537","7.929","19537","1002","1015","4464","9195","18069","27264","10.77","3.632","20147","27630","7483","10.915","2.956"
"Wisconsin","2005","256231","17035","6278","2.45","21.632","1871","9.536","1647","8.394","19733","1083","1095","5289","10952","23040","33992","13.266","4.274","19214","27714","8500","10.816","3.317"
"Wisconsin","2006","260525","17126","2572","0.987","21.655","2031","10.25","1763","8.898","19948","1270","1281","5273","9950","20830","30780","11.815","3.819","19714","28208","8494","10.827","3.26"
"Wisconsin","2007","261319","17167","-311","-0.119","24.296","1906","9.566","1818","9.124","19969","1120","1130","4454","9908","21837","31745","12.148","3.792","21957","32056","10099","12.267","3.865"
"Wisconsin","2008","260503","16888","-122","-0.047","23.316","1658","8.377","1878","9.489","19682","1193","1202","5980","10202","20168","30370","11.658","3.916","20353","30492","10139","11.705","3.892"
"Wisconsin","2009","257997","16394","-6733","-2.61","21.759","1516","7.782","1982","10.173","19249","1212","1229","5932","10880","17189","28069","10.88","4.217","25356","34802","9446","13.489","3.661"
"Wisconsin","2010","254344","16230","-1174","-0.462","20.755","1494","7.8","1600","8.353","19102","990","998","4058","9116","17279","26395","10.378","3.584","20735","27569","6834","10.839","2.687"
"Wisconsin","2011","253872","16055","830","0.327","20.672","1555","8.197","1701","8.966","18898","1069","1090","4416","7140","19930","27070","10.663","2.812","18030","26240","8210","10.336","3.234"
"Wisconsin","2012","259660","16067","11096","4.273","19.69","1663","8.798","1554","8.221","18957","1003","1029","4842","9229","27430","36659","14.118","3.554","17740","25563","7823","9.845","3.013"
"Wisconsin","2013","259808","15946","-7360","-2.833","21.525","1447","7.663","1472","7.795","18871","934","934","13547","7705","20257","27962","10.763","2.966","18744","35322","16578","13.595","6.381"
"Wisconsin","2014","258468","15941","2217","0.858","19.37","1515","8.031","1467","7.777","18888","945","978","5340","7555","19694","27249","10.543","2.923","16917","25032","8115","9.685","3.14"
"Wisconsin","2015","262252","15997","5882","2.243","17.19","1472","7.776","1312","6.93","19011","894","905","3568","8264","20159","28423","10.838","3.151","16766","22541","5775","8.595","2.202"
"Wisconsin","2016","266115","16019","1560","0.586","19.007","1502","7.885","1362","7.15","19119","927","939","3883","7759","19091","26850","10.09","2.916","18640","25290","6650","9.503","2.499"
"Wisconsin","2017","259522","15948","-1903","-0.733","21.65","1428","7.502","1486","7.807","19006","1005","1015","5475","7461","20632","28093","10.825","2.875","21462","29996","8534","11.558","3.288"
"Wisconsin","2018","259950","15852","2996","1.153","18.134","1306","6.899","1382","7.301","18891","1024","1040","5220","7779","18787","26566","10.22","2.993","15634","23570","7936","9.067","3.053"
"Wyoming","1978","1433757","76432","110875","7.733","27.973","13928","15.384","9757","10.777","92621","6304","6401","34581","109454","201954","311408","21.72","7.634","117398","200533","83135","13.987","5.798"
"Wyoming","1979","1529068","79345","88624","5.796","26.264","13164","13.983","8976","9.535","96235","6106","6172","30892","100927","188497","289424","18.928","6.601","130889","200800","69911","13.132","4.572"
"Wyoming","1980","1603196","79479","-846","-0.053","32.621","12113","12.596","10703","11.13","96872","7252","7357","34563","96322","165169","261491","16.311","6.008","182609","262337","79728","16.363","4.973"
"Wyoming","1981","1614989","80198","30443","1.885","28.304","12076","12.415","9680","9.951","98471","6367","6531","34376","111774","147220","258994","16.037","6.921","152718","228551","75833","14.152","4.696"
"Wyoming","1982","1632938","79829","13527","0.828","31.072","12720","12.934","10928","11.112","99239","7433","7550","38377","114392","152828","267220","16.364","7.005","175464","253693","78229","15.536","4.791"
"Wyoming","1983","1631461","82816","27319","1.675","28.885","13294","13.278","8405","8.395","102565","5646","5790","32958","93175","169764","262939","16.117","5.711","170116","235620","65504","14.442","4.015"
"Wyoming","1984","1702050","87194","141535","8.316","21.846","15895","15.212","9429","9.024","107720","6820","6920","36854","115795","211658","327453","19.239","6.803","119548","185918","66370","10.923","3.899"
"Wyoming","1985","1820703","90819","115868","6.364","25.701","17017","15.516","12387","11.294","111992","9255","9398","56737","131642","218196","349838","19.214","7.23","138804","233970","95166","12.851","5.227"
"Wyoming","1986","1925537","94084","133407","6.928","25.102","16532","14.603","10194","9.004","116381","6987","7091","38944","152406","222675","375081","19.479","7.915","165070","241674","76604","12.551","3.978"
"Wyoming","1987","2045474","97490","104688","5.118","29.948","18050","15.248","11502","9.717","121649","7769","7911","47869","165824","245158","410982","20.092","8.107","198219","306294","108075","14.974","5.284"
"Wyoming","1988","2154395","102385","106944","4.964","28.811","18722","15.003","11880","9.52","128212","8086","8243","51604","169747","247547","417294","19.369","7.879","205489","310350","104861","14.405","4.867"
"Wyoming","1989","2251746","105496","94880","4.214","27.896","18800","14.475","12444","9.581","133057","8759","8996","53058","164262","244696","408958","18.162","7.295","203004","314078","111074","13.948","4.933"
"Wyoming","1990","2320557","108007","67077","2.891","27.785","18038","13.44","12791","9.531","136834","9195","9417","55007","149739","239720","389459","16.783","6.453","225219","322382","97163","13.892","4.187"
"Wyoming","1991","2294724","106504","-92611","-4.036","28.746","16684","12.274","15018","11.048","136768","10329","10693","71854","145170","184656","329826","14.373","6.326","296921","422437","125516","18.409","5.47"
"Wyoming","1992","2249609","107115","28759","1.278","29.77","16093","11.817","13555","9.953","137453","8689","8909","48686","131416","232193","363609","16.163","5.842","234653","334850","100197","14.885","4.454"
"Wyoming","1993","2286162","109722","49013","2.144","27.623","15985","11.551","13284","9.599","139735","8344","8623","47652","127932","236839","364771","15.956","5.596","213024","315758","102734","13.812","4.494"
"Wyoming","1994","2352596","112463","56827","2.416","26.857","16478","11.659","13116","9.281","143009","8614","8840","51768","134267","238481","372748","15.844","5.707","208772","315921","107149","13.429","4.555"
"Wyoming","1995","2429136","115872","91407","3.763","25.523","17559","12.124","13131","9.066","147048","8803","9075","53533","147214","254186","401400","16.524","6.06","196860","309993","113133","12.761","4.657"
"Wyoming","1996","2479029","116844","36165","1.459","28.619","16960","11.505","14224","9.649","148788","9560","9861","54601","144135","246769","390904","15.768","5.814","238738","354739","116001","14.31","4.679"
"Wyoming","1997","2554668","119029","118186","4.626","28.135","18679","12.447","15318","10.208","151743","9570","9976","61080","168177","309381","477558","18.694","6.583","227818","359372","131554","14.067","5.15"
"Wyoming","1998","2662542","121288","67902","2.55","28.201","18164","11.844","14809","9.656","155038","9041","9414","60656","165499","277829","443328","16.651","6.216","235814","375426","139612","14.1","5.244"
"Wyoming","1999","2735675","121994","81282","2.971","26.893","17077","10.989","15221","9.794","156335","9254","9594","58813","156042","293095","449137","16.418","5.704","241853","367855","126002","13.447","4.606"
"Wyoming","2000","2838383","122979","104817","3.693","27.226","17245","10.984","15037","9.577","158109","9144","9462","56074","167157","324043","491200","17.306","5.889","240250","386383","146133","13.613","5.148"
"Wyoming","2001","2916089","123972","38065","1.305","30.085","17456","11.007","15366","9.689","159640","9078","9460","59101","179649","297072","476721","16.348","6.161","301574","438656","137082","15.043","4.701"
"Wyoming","2002","2930968","125323","-33656","-1.148","33.088","19180","11.93","16595","10.322","162064","9546","9892","80977","193082","291822","484904","16.544","6.588","335525","518560","183035","17.692","6.245"
"Wyoming","2003","2916179","127413","11019","0.378","29.313","18527","11.359","15564","9.542","164584","9068","9384","55893","149146","289285","438431","15.034","5.114","282439","427412","144973","14.657","4.971"
"Wyoming","2004","2979350","131278","107734","3.616","24.926","19366","11.611","14370","8.615","169295","8804","8988","52647","157019","322026","479045","16.079","5.27","252818","371311","118493","12.463","3.977"
"Wyoming","2005","3052507","134721","22089","0.724","27.895","20143","11.766","15810","9.235","173358","9830","10119","54933","160355","287479","447834","14.671","5.253","299193","425745","126552","13.947","4.146"
"Wyoming","2006","3122018","138315","119554","3.829","25.285","23294","13.23","16756","9.517","179334","11539","11710","67268","186369","327887","514256","16.472","5.97","265765","394702","128937","12.643","4.13"
"Wyoming","2007","3180586","139555","2128","0.067","30.791","20804","11.535","17655","9.789","181928","10833","10990","60083","169550","322238","491788","15.462","5.331","342439","489660","147221","15.395","4.629"
"Wyoming","2008","3170306","138250","-21197","-0.669","27.855","18032","9.967","19126","10.571","180374","11920","12128","60907","136865","304687","441552","13.928","4.317","309000","462749","153749","14.596","4.85"
"Wyoming","2009","3106701","134797","-120598","-3.882","23.897","16808","9.372","19411","10.824","178035","12311","12541","69626","146910","224296","371206","11.949","4.729","352081","491804","139723","15.83","4.497"
"Wyoming","2010","3022635","133092","-51678","-1.71","24.324","16306","9.213","17505","9.891","176382","10366","10714","61302","124958","242661","367619","12.162","4.134","284004","419297","135293","13.872","4.476"
"Wyoming","2011","3013358","132242","30606","1.016","24.338","17302","9.823","16899","9.595","176333","10321","10628","51373","126769","270529","397298","13.185","4.207","258459","366692","108233","12.169","3.592"
"Wyoming","2012","3056870","132846","58504","1.914","24.708","16493","9.358","15658","8.884","176663","9046","9312","47329","119402","316746","436148","14.268","3.906","267582","377644","110062","12.354","3.6"
"Wyoming","2013","3093377","133239","31778","1.027","24.411","16950","9.586","15591","8.818","177494","8942","9111","50245","132927","276408","409335","13.233","4.297","259470","377557","118087","12.205","3.817"
"Wyoming","2014","3121032","133693","30172","0.967","22.751","16681","9.367","14631","8.216","179099","9255","9410","43740","125806","259394","385200","12.342","4.031","254493","355028","100535","11.375","3.221"
"Wyoming","2015","3173176","134663","59232","1.867","21.866","16966","9.442","14955","8.323","180685","9177","9364","47655","138746","267403","406149","12.799","4.372","240007","346917","106910","10.933","3.369"
"Wyoming","2016","3234346","135969","60113","1.859","21.494","17461","9.599","14212","7.813","183538","9326","9564","49460","132492","275219","407711","12.606","4.096","247361","347598","100237","10.747","3.099"
"Wyoming","2017","3277473","136785","45717","1.395","22.492","16431","8.947","15351","8.359","184185","9787","10003","56221","115172","299134","414306","12.641","3.514","254683","368589","113906","11.246","3.475"
"Wyoming","2018","3337281","137189","71861","2.153","20.494","15716","8.54","15178","8.248","184297","10514","10834","57359","116947","296885","413832","12.4","3.504","237638","341971","104333","10.247","3.126"
